..ved at ...
med at 
færd med
gang med	about to
aben	the monkey
åbne	open
åbnede	opened
åbnedes	were opened
was opened
åbnes	opens
am/are/is opened
åbnet	opened
åbningen	the opening
ad døren	through the door
adgang	access
adgangen	the access
advokaten	the lawyer
ægteskab	marriage
ældre	older
ælling	duckling
ændre	change
ændredes	were changed
ændrer	will change
changing
is changing
ændres	is being changed
is changed 
be changed
ændret	changed
æren	the honour
afgrøden	the crop
afmærker	marks
afslutning	ending
afsluttes	ended
is ended
ends
afsluttet	finished
afsnit	episode
afstanden	the distance
agurker	cucumber
aldrig	never
alene	alone
alkoholen	the alcohol
alle	everyone
alle steder	everywhere
allerede	already
alt	everything
altid	always
anderledes	different
andre	other
angrebene	the attacks
ankommer	is arriving 
is
will arrive
ankommet	arrived
anledningen	the occasion
annoncerer	announce
ansigtet	the face
ansvaret	the responsibility
ansvarlig	responsible
antage	assume
antager	assume
antaget	assumed
antal	number
år	year
arbejdede	did work
was/were working
worked
arbejderne	the workers
årene	the years
armbåndsuret	the watch
årsagen	the cause
årtier	decades
artikel	article
at	that
at købe ind	shopping
at virke	work
atlet	athlete
avisdrengen	the paper boy
bad	asked

was/were asking
både	both
båden	the boat
badeværelset	the bathroom
bakken	the hill
ballade	trouble
bandet	the band
bange	afraid
barberer sig	shaves
bare	just
bare	just
bede	ask (politely - may I ask)
bedre	better
bedst	best
bedste	best
begge	both
begravelse	funeral
begynde	begin
begyndelsen	the beginning
begynder	start
begyndte	began
behandler	treats
treat
is treating
behandling	treatment
care
beholde	keep
beholdte	kept
behøvede	did have to 
had/have to
was/were needing
behøver	need
behøves	is necessary 
be needed
benzinen	the gasoline 
the petrol
berømt	famous
beskeden	the message
beskidte	dirty
beslutning	decision
besluttede	decided
besluttet	decided
besøge	visit
besøgende	visitors 
visiting
besøger	am/is/are visiting 
visit
visits
bestemt	definitely
bestilt	ordered
bestyrelsen	the board of directors
besvare	answer
betal	pay
betale	pay
betalt	paid
betjenten	the officer
betjentene	the officers
betydningen	the meaning
betydninger	meanings
bevis	evidence 
proof
bilen	the car
billedet	the picture
billigere	cheaper
biografen	the cinema
bjerget	the mountain
blad	magazine
bladet	the leaf
bland	mix
blander	mixes
blandt/iblandt	among
blev på	stayed at
blev til	turned into
blevet	become 
been
blive	stay
bliver aldrig	will never be
become 
are being
bliver dræbt	is killed
bliver fyldt	is being filled
bliver gemt	are being hidden/saved
bliver købt	is bought 
is being bought
bliver rød i ansigtet	blushing
bliver skudt	is shot
bliver sunget	being sung
bliver svigtet	is being let down
bliver talt	are being counted
bliver tilbudt	is being offered
blomsten	the flower
bo	live
boet	lived
bolden	the ball
bolle	bun
bor	lives (in a home)
bør	ought to
should
bordet	the table
bordskåner	trivet
boren	the bridge
brændende	burning
brændet	the wood
brandmændene	the firemen
brevet	the letter
brødrister	toaster
brug	needs
need
bruge	use
bruger tid	spends time
bruges	is being used
brugt	used
brugte	used
brugtes	was used
were spent
bryllup	wedding
brystkassen	the chest
budgettet	the budget
bukserne	the pants
burde	should
butikken	the shop
by	town
city
bygget	built
bygning	building
chefen	the manager
computeren	the computer
cykelstier	bicycle paths
cykler	bikes
da	really
after all
since
when
da	when
dække	cover
dækker	am/are/is covering
cover
covers
dækker bord	set the table
dalen	the valley
dame	lady
dannebrog	the Dannebrog
dansen	the dance
dårlige	bad
dårligt	bad
poor
De	you (polite)
the 
those
de andre	the other
definere	define
definitionen	the definition
dejlige	lovely
nice
den	that
der arbejdes	work is being done
derefter	then
Deres	your -polite
derhenne	over there
derinde	in there
det bliver	it will be
det her	this
det meste	most things
most
det var dejligt med noget	it was nice to get some
det var så lidt	you are welcome
detaljen	the detail
dette/denne	this
diskussion	discussion
disse	these
djævlen	the devil
dø	die
døde	died/dead
døden	death 
the death
dommer	judge
dræbt	was killed
drak	drank
drejede	turned
drikke	drink
drøm	dream
drømme	dreams
dronning	queen
drukket	drunk 
did drink
dukkede ... op	appeared
dukkede aldrig op	never appeared
dukker op	are showing up
turning up
show up
dyb	deep
dybden	the depth
dyd	virtue
dynen	the duvet
dyr	expensive
efter	after
for
efterlader	leave
efterlod	left
efterspørgselen	the demand
egen	own
ejendom	property
eksistere	exist
elektrisk	electric
elev	pupil
ellers	else (who else is there)
elskede	loved
emne	subject
en	one
én	you
oneself
en anden	another
en del af	a number of 
a part of
en eller anden	somebody
en gang	once
end	than 
besides
endelig	finally
endnu	yet (they are not doctors yet)
endnu en	yet another
endnu ikke	not yet
engle	angels
enhederne	the units
ens	one's
er ... enig	does agree
agrees
er ... gået	has ... gone (has already gone)
er lige meget	does not matter
erfaring	experience
et sted	somewhere
etableret	established
eventyret	the adventure
få	get
fængsel	prison
færdig	completely 
ready
finished
færdiggøre	finish
complete
færre	fewer
færrer	fewer
fået	had
gotten
received
faldende	dropping
falling
faldt	fell
fandt	found
får jeg	will I get
faren	the danger
farfar	grandfathers
farligt	dangerous
farmor	grandmother
fås	can be had
fattig	poor
fed	cool
fat
fejlen	the mistake
fem	five
femten	fifteen
festen	the party
fiasko	failure
fik	got
recieved
had
fik fat i	caught
filosofi	philosophy
finde	find
finder ... sted	take place
finder på	come up with
findes	exist
am/are/is found
exists
fire	four
firma	firm
fjender	enemies
fjernsynet	the television
fjolle rundt	goofing around
fjollet	being silly
fjorten	fourteen
flere	more
flere timer	several hours
flertallet	the majority
flest	most
fleste	majority
most
floden	the river
flot	handsome
pretty
flydende	fluent
flyet	the airplane
flyver	flies
is/are/am flying 
fly
fodbold	football
foden	the foot
fødselsdag	birthday
fødselsdagsgaver	birthday presents
født	born
føle	feel
føler	feel
føles	feel
feels
følg efter	follow
følger	follows
følges	is followed
are followed
følt	felt
følte	felt
før	until
for	with
for at	in order to 
so that 
to
for nylig	recently
for øjeblikket	currently
for sent	too late
for tiden	at the moment/currently
forældre	parents
foran	in front of
forbedre	improve
forberede	prepare
forberedelse	preparation
forberedt	prepared
forbrydelse	crime
fordele	benefits
fordelen	the benefit
fordi	because
forekom	seemed
forelsker	fall/falls in love
forelsket	in love
forfærdeligt	terrible
forfatteren	the writer
forførende	seductive
seducing 
seductively
forfremmelser	promotions
forhindre	prevent
forhold	relationship
forholdet	the relationship
forkert	wrong
forklare	explain
forklarede	explained
forklarer	explains
forklaring	explanation
forklaringer	explanations
forlade
efterlade	leave
forlader	leave
forladt	left
forlod	left
form	shape
formål	purpose
formler	formulas
fornøjelsen	the pleasure
forrige	previous
forsikringen	the insurance
forskel	difference
forskellige	different
forskeren	the scientist
forskningen	the research
forsøg	attempts
forstå	understand
første	first
fortæl	tell
fortælle	tell
fortælles	is told
being said
fortalt	told
fortalte	told
fortjent	deserved
fortsætte	continue
fortsætter	continues
fortsættes	is continued
is being continued
foruroligende	disturbing 
worrying
freden	the peace
fremragende	excellent
fremskridt	progress
friheden	the freedom
frimærke	stamp
frøken	miss
frue	ma'am
frugtsaft	fruit juice
frygt	fear
fryser	freezer
fuld	drunk
full
fuldstændigt	completely
fulgt	followed
fulgte	was/were following
followed
did follow
fulgtes med	walked along with
fundet	found
fylder	fill
fyldes	is filled 
is being filled
are filled
fyldtes	was being filled
was filled
fysik	physics
gå	walk
gælden	the debt
gået	has gone
have gone
have walked
gaflen	the fork
gamle	age
old
gammel	old
gammelt	old
gang	time
går	walk
går det godt	are you doing well
går henimod	walks towards
går med til	agrees to
gassen	the gas
gav ... mad ( gav hesten mad)	fed (fed the horse)
gaven	the present
gem	hide
gemmer	hiding
gemmer sig	is hiding
gemmes	be hidden
being saved
gennem	through
gennemsnitlig	average
genstande	objects
gentage	repeat
geografien	the geography
gik	went
gik ind	entered 
went in
gives	am/are/is given
givet	given
gjorde	did
gjort	done 
made
glæden	the joy
glæder	am/are/is looking forward /looks forward
glemme	forget
godt	well (she swims well)
gør ondt	hurts
gøre	do
grædende	crying
græder	is crying
grænsen	the border
græsset	the grass
gratis
fri
frie	free
grav	grave
grimme
grim	ugly
grøntsag	vegetable
grunden	the reason
grundet	due to/ because of
gryde	pot
grydelap	pot holder
gud	god
gul	yellow
guldet	the gold
gule	yellow
gulvet	the floor
håber	hope
håber på det	hope so
hade	hate
hader	hate
hader virkelig	really hate
hadet	the hate
hæren	the army
haft	had
hajen	the shark
halsen	the throat
the neck
halvdelen/halvdel	half
håndbold	handball
hånden	the hand
handlen	the trade
har brug for	need 
needs
har endda	even has
har ikke engang	dont even have
hårdt	hard
solid
håret	the hair
hastigheden	the speed
havde	had
have	garden
havet	the sea
havfrue	mermaid
havvand	seawater
hekse	witches
hel	whole
heldig	lucky
hele	all
hele dagen	all day
hele dagen	all day
helt	entirely
hemmelighed	secret
hen	over
hente	get
henter	am/are/is getting
am/are/Is fetching 
get
himlen	the sky
hinanden	each other
hjælpe	help
hjælpen	helping
hjem	home
hjernen	the brain
hjertet	the heart
hjørnet	the corner
hjul	wheel
høj	tall
højden	the height
høje	tall
højt	high
aloud 
loudly
hold	hold
team
teams
holdet	the team
holdning	opinion
attitude
hoppede	jumped
høre til	belong
høres	be heard
hørt	heard
hørte	heard
hørtes	was heard
were heard
hos	at
hos dig	at your place
hovedet	the head
hovedstad	capital
hr	sir
hud	skin
hukommelse	memory
hukommelsestab	amnesia
hurtige	quick
fast
hurtigt	fast
huske	remember
huskede	did remember
husker	remember
hvad	what
hvalen	the whale
hvem som helst	anybody
hver	every
hverken	neither
hverken ... eller	neither ... nor
hvile	rest
hviler	rests
hvilken som helst	whichever
hvis	whose
hvor	where
hvor meget	how much
hvor som helst	anywhere
hvordan	how
hvordan har du det	how are you feeling
hvornår	when
hyg jer	have a good time
make yourself comfortable
hyggede	was/were chilling out
hyggen	the coziness
the cheerfulness
the homeliness
hyppigt	frequent
I aften	tonight
I det mindste	at least
I går	yesterday
I stand til	able
iblandt
blandt	among
idéer	ideas
identiteten	the identity
ifølge	according
igen	again
ikke i stand	unable
ikke mere	not anymore
ikke noget	nothing
ilden	the fire
imidlertid	however
imod	towards/against
importerer	import
importeres	are/is imported
ind	in
inde	inside
indeholder	contains
indgangen	the entrance
indsatsen	the effort
indtil nu	so far
informerede	informed
ingen	no/no-one/nobody
ingenting	nothing
internettet	the internet
interviewet	the interview
intet som helst	nothing at all
introducerede	introduced
irriterende	annoying
især	especially
jeg hygger	I make myself comfortable
jeg savner dig	I miss you
jeg vidste det	I knew it
jer	yourselves
you (plural)
jo	I tell you 
you know
you see
jorden	the earth
jubilæum	anniversary
jul	christmas
julegaver	Christmas presents
julemanden	santa claus
kæledyr	pet
kæreste	girlfriend/boyfriend
kærlighed	love
kærligheden	the love
kald	call
kaldt	called
kaldte	called
kameraet	the camera
kammen	the comb
kampagnen	the campaign
kampene	the fights 
the matches
kan ... passe	do fit
kan godt lide	like
kan ikke	cannot
kan ikke lide	does not like
kan ikke sove	cannot sleep
kan...nå	do ... have time/can..make it/can...reach
kanal	channel
karakteren	the character
kasser	boxes
ked af det	sorry
sad
kedel	kettle
kedelig	boring
kejseren	the emperor
kemi	chemistry
kendt	known
kendte	knew
ketsjer	racket
kigge	look
kiggede	looked
kigger	looking
kister	coffins
klæder	clothing
klæder sig ud	dresses up
klar	ready
clear
klare	clear
klaret	finished 
completed
succeeded at
klimaet	the climate
kloge	smart
wise
klokken	the bell
klokken seks	6 o'clock
kniven	the knife
købe	buy
køber	will buy/buy/buying
køber ind	shops
købes	is bought 
be bought
købt	bought
koen	the cow
kogeplade	burner
koges	is boiled 
boil (passive present)
kokkene	the chefs
kolde	cold
køleskabet	the refrigerator
kom	came/arrived/got
komfuret	the stove
komme sig	recovered
recover
kommentar	kommentar
kommer til	will
kommer til syne	appears
konflikten	the conflict
konklusion	conclusion
konkurrencen	the competition
konsekvenserne	the consequences
kontoret	the office
kontrakter	contracts
koppen	the cup
køre	drive
køretøjet	the vehicle
korn	grain
kors	cross
kort	map
kost	diet
koster	costs
krævedes	was required
krævende	demanding
kræver	demand
kræves	is required
kreditkort	credit card
krigen	the war
krise	crisis
krop	body
kuglepennen	the pen
kun	only
kunne	could
kunne ikke lide	did not like
kunsten	the art
kurv	basket
kvaliteten	the quality
kys	kiss
kysser	kisses
kysten	the coast
lå	lay
lad	let
lade være	stop
lader	lets
læbe	lip
læg	put 
lay
lægemiddel	drug
lægen	the doctor
lægger	puts 
lays
put
lænestol	armchair
længden	the length
længe	long (how long)
lære	learn/teach
lærer	teacher
læs	loads
læst	read
lagde	put
låget	the lid
landet	the country
landsby	village
landskabet	the landscape
lange
langt	long
langsomt	slowly
larmende	loud
noisy
lav	make
do
fix
lave mad	cook
lavede	were/was doing/making did/cooked
laver	cook
laves	be fixed
is/are made
lavet	cooked
made
repaired
lederen	the leader
ledt	led
leg	game
play
lege	play
legende	playing
leje	rent
lektien	the homework
leve	live
lever	alive
leverer	deliver
leveringen	the delivery
lide	suffer
lidt	a bit
a little
lige	the same
equally
just
lige nu	right now
lige så meget	just as much
ligeglade	indifferent 
do not care
ligegyldige	irrelevant
ligger	is 
am/are/is lying
lies (on the bed)
lilla	purple
linjen	the line
litteraturen	the literature
liv	lives
løb	run
løb en tur	went for a run
løbe	run
løber	runs
lod	let
løsning	solution
love	laws
lovene	the laws
luften	the air
lukke	close
lukket	closed
lydstyrken	the volume
lykke	bliss
happiness
lykkeligt	happy
lys
lyst	lights
lysende	glowing
lyserød	pink
lyset	the light
lyt	listen
lytte	listen
lyttede	listened
må	must
måde	way
mængde	amount
mærke	brand
mærkede på	touched 
felt
was/were feeling
mætte
mæt	full
magi	magic
magten	the power
mål	aim
goal
measures 
measurements
maleriet	the painting
malingen	the paint
man	one (indefinite pronoun)
måneder	months
månen	the moon
mange	many
mangel	lack
maratoner	marathons
marken	the field
maskinen	the machine
måtte	was/were allowed to
maven	the stomach
medlemmer	members
meget	very
men	but
mening	opinion
mere	more
mest	most/the most
mesterskabet	the championship
metode	method
mikrobølgeovn	microwave
minder	memories
mindre	less
mindske	decrease
mindsker	reduce
mindst	at least
miste	lose
mistede	lost
mistet	lost
møde	meet
moden	the fashion
mødes	will meet
meet
will be met
mødet	the meeting
modsatte	opposite
mødt	met
modtager	receives
modtaget	received
mødtes	met
moms	sales tax
mordet	the murder
mørkeblåt	dark blue
mørket	the dark
mørkt	dark
motionere	exercise
mund	mouth
musicalen	the musical
nå	catch
nabolag	neighbourhood
næsen	the nose
næsten	almost
nakken	the back of the neck
når	when
når	when
når som helst	whenever
natbordet	the night table
navn	name
ned	down
ned i	into
nederdel	skirt
nederen	suck
sucks
nemt	easily
netværket	the network
ni	nine
nødder	nuts
nødsituationen	the emergency
nødvendigvis	necessarily
nogen	any/someone
nogensinde	ever (do you ever drink)
noget	something
nogle	some
nøglen	the key
nok	enough/sufficient/probably
nu	now
nye	new
nyheder	news
nyhederne	the news
ødelægger	am/is/are destroying
destory
ruins
ødelagt	are being destroyed
øen	island
offentligheden	the public
offeret	the victim
ofte	often
øge	increase
også	also
øjebikket	the moment
øjeblikke	moments
øjet	the eye
økonomi	finances
omkring	around
områder	areas
omtrent	approximately
onde	evil
ondskab	malice
ondskaben	the malice
ondt	pains
a pain
ønsker	want
ønsker du dig	do you wish for
ønsker sig	wishes for
ønsker sig en	wishing for a
ønskes	is/are wanted
op	up
op af	out of
opdager	discovers
opdaget	discovered
opdangede	discovered
opdrager	is raising
opdrages	are raised
is raised
opførsel	behaviour
opgaven	the task 
the assignment
opkaldet	the call
oplevelsen	the experience
opmærksom	attentive
opmærksomme	aware
opnå	achieve
oprindelsen	the origin
optrådt	performed
optrådte	performed
optræde	appear
perform
performing
opvaskemaskinen	the dish washer
ord	words 
word
øret	the ear
osteskæreren	the cheese slicer
otte	eight
øve	practise
øvelse	practise
oven på	on top of
over	above
overfladen	the surface
overrakelsen	the surprise
overveje	consider
ovn	oven
på	on
på grund af	because of (not because of you)
pakkerne	the packages
palads	palace
panden	the pan
papiret	the paper
par	couple
paraply	umbrella
parrets	couple's
påske	easter
passer	do fit
fit
am/is/are fitting
påvirke	affect
pengene	the money
personer/folk/mennesker	people
personligheden	the personality
pinsen	pentecost
placere	place
planer	plans
planeten	the planet
plejer at	usually/used to/tends
pludselig	suddenly
poesien	the poetry
postkort	postcard
præcist	exactly
præmien	the prize
præsidenten	the president
præsten	the priest
præsterede	managed (managed to do something)
pressen	the press
prikkerne	the dots
producerer	produce
produceres	are/is/be produced
prøv	try
prøve	try
prøvede	tried on
prøver	trying
prøvet	tried
publikummet	the audience
pulveret	the powder
pung	wallet
pungen	the wallet
putte	put
putter	put
råber	yell
råd	advice
rækker	hand (hand me something)
ræven	the fox
red	save
rescue
reduceret	reduced
regeringen	the government
regnbuen	the rainbow
regnede	rained
regner	am/are/is calculating 
is raining
calculates
regner med	am/are/is counting on/count on/ counts on
regnet	rained
regningen	the bill
rejsen	the journey
rejser	travels
reklamen	the advertisement
relationer	relations
renere	cleaner
renten	the interest
reserverer	reserves
respekterer	respect
ret	pretty
retfærdig	fair
retning	direction
retten	the court
returnere	return
returnerede	returned
rig	rich
rigdom	wealth
ringede til	called
ringet	called
røgen	the smoke
rollemodeller	role models
romanen	the novel
romanforfatter	novelist
røre	touch
rørte	touched
rummet	the space
rumvæsen	alien
rundt om	around
ryger	do smoke/are smoking/smokes
ryggen	the back
rygsækken	the backpack
så	so
sad	sat
sådanne	such
sådanne ting	such things
sæber	soaps
sædvanligvis	usually
sælge	sell
sætningen	the sentence
sætte	put
sætter sig	sit down
sits down
sits
sagde	said
sagt	said
saksen	the scissors
samfund	society
community
samlingen	the collection
sammen	together
samtalen	the conversation
sande	true
sandheden	the truth
sås	were being seen
was seen
satte	put
satte ild til	lit
ignited
savne	miss
savner	miss
savnes	are missed
is missed
are missing
savnet	missed
se	see
sedlen	the note
sejt	tough
cool
seks	six
selv	even (even him)
selvfølgelig	of course
selvom	though
sende	send
senere	later (until later)
sengen	the bed
sengetøjet	the bed sheet
sent	late
ser sjov ud	looks funny
seriøst	seriously
serverer	serve
ses	be seen
set	seen
sid	sit
sidder	am/are/is sitting
sits
sit
siden	since 
the side
sidste	last
sig selv	itself
sige	say
sikker	sure
sikkerhed	security 
safety
sikre	safe
simpelt	simple
sjov	fun
skabet	the cabinet
skabsnøglerne	the locker keys 
the cabinet keys
skaden	the damage
skænderier	arguments
skærer	cuts
am/is/are cutting 
cut
skæres	is cut
skærm	screen
skærmen	the screen
skal	must
shall
should
has to
skala	scale
skålen	the bowl
skåret	cut
skarp	sharp
skat	tax
honey
darling
ske	happen
spoon
skete der	happened (e.g. what happened)
skete der med	happened to
skinnende	shiny
shining
skønhed	beauty
skoven	the forest
skovture	picnics
skraberen	razor
skraldespanden	the bin
skrev	wrote
skrevet	written
skridt	step
steps
skrigende	screaming
skrive	write
skrivebordet	the desk
skuespillerinden	the actress
skulle	should
sky	cloud
skyggen	the shadow
skylden	the fault
the blame
slå	beat
slaget	the battle
slags	kind of
slappe af	relax
slog	beat
slog mig	hurt myself
slot	castle
sluttede	ended
slutter	ends
smerter	pains
smilende	smiling
smilet	the smile
smør	butter
smuk	beautiful
smukke	pretty
smukkere	more beautiful
prettier
smykke	piece of jewellery
snakke	speak
snakkede	talked
snart	soon
sneboldskamp	snowball fight
sød	cute
sweet
nice
søde	sweet
cute
sweetheart
søen	the lake
søger	look
søgningen	the search
søgninger	searches
søgte	were seeking 
seeking
solen	the sun
sommetider	sometimes
sort	black
sov	sleep
slept
was sleeping
sove	sleep
sovende	sleeping
sparke	kick
sparker ... til	kick
kicks
spejl	mirror
spidsen	the point
spil	play
game
games
spillede	played
spiller	plays
player
spilles	is being played
spillet	played
spises	is eaten
spist	eaten
spiste	ate
spøgelser	ghosts
spørge	ask
spørger	is playing
spurgt	asked
spurgte	asked
spurgte	asked
was/were asking
stadig	still
stærke	strong
står	standing
står i	written in
står i gæld	am in debt 
owe
starte	start
startede	started
statsministeren	the prime minister
stearinlys	candles
candlelight
stemme	vote
stenen	the stone
sti	path
stilen	the style
stille	place
stilling	position
stillinger	positions
stjæler	steal
stjernen	the star
stod	stood
støjen	the noise
stol på	trust
stolen	the chair
stoler	trust
stoler på	trust
stoppede	stopped
store	big
større	bigger
størrelse	size
største
størst	biggest
stort	big
støttede	supported
støv	dust
stranden	the beach
strejke	strike
studere	study
studerer	studies
stykker	pieces
stykket	the piece
styrken	the strength
sultne	hungry
sur	sour
angry
sure	angry
svage	weak
svampen	the sponge
svar	answer
svarede	answered
svigter	fail
svigtes	is let down
are let down
svinedrengen	the swineherd
svømmebassinet	the pool
svovlstikkerne	the matches
syg i hovedet	insane
sygdom	illness
disease
syge	sick
ill
sygehuset	the hospital
symbolet	the symbol
synd	a shame
sin
syng	sing
synges	is sung
syv	seven
taber	loses
tælle	count
tæller	count
tælles	are counted
be counted
tænke	think
tænker over	thinks about
tænkte	thought (thought about)
tæpper	blankets
tag	take
tage afsted	go
leave
tager på tur	going on a trip
tages	is taken
taget	the roof
tal	speak
taler	talking
talerne	the speeches
tales	is talking
Is spoken
spoken
talt	spoken
talte	spoke
tasken	the bag
teateret	the theatre
tekoppen	the teacup
teksten	the text
teorierne	the theories
ti	ten
tid	time
tiden	the time
tidligere	previously 
previous
tidligt	early
tilbuddet	the offer
tilbyde	offer
tilbyder	is offering
tilbydes	am/are/is being offered
tilføje	add
tilføjede	did...add
tilføjer	am/is/are adding
add
adds
tilladelse	permission
tillader	allowing
am/is/are allowing
allows
tilladt	allowed
tilløjer	add
tilstand	condition
tilstrækkeligt	adequately
time	hour
ting	things
tjeneren	the servant 
the waiter
tjeneste	favour
to	two
tog	took
tog fat i	grabbed
toget	the train
tøj	clothes
tolv	twelve
tør	dare
tørrer	dry
tørstig	thirsty
træet	the tree
træls	annoying
træne	train
træneren	the coach
træt	tired
trafikken	the traffic
tre	three
tre gange	three times
tredje	third
trend	trend
tretten	thirteen
trist	sad
tro	believe
faith
belief
troede	thought
troede...på	believed
did believe
thought
tror	do think
think
is believing
tror jeg	I think
trussel	threat
tungen	the tongue
turde	did dare
tv'et	the tV
tvivl	doubt
tvunget	forced
tydeligt	clearly
tyve	twenty
ud	out
uddannelse	education
ude	out
uden	without
udenlands	abroad
udgangen	the exit
udgaver	editions
udsalg	sale
udseendet	the look
udsigt	view
udtryk	expressions
udvikle	develop
udviklet	developed
uger	weeks
ulven	the wolf
ulykke	accident
undergrundsbanen	the subway
underlig	strange
underskriften	the signature
underskriver	signing
undersøgelsen	the investigation
undgå	avoid
ungdom	youth
ungt	young
unkluderer	include
ur	clock
uret	the clock
uvejret	the bad weather
våbenet	the weapon
væggen	the wall
vægt	weight
væk	away (running away)
vække	wake
vælge	choose
værd	worth
være	be
været	been
værre	worse
værste	worst
vagten	the guard
valget	the election
valgt	elected
chosen
valuta	currency
vanskelighederne	the difficulties
var	was
varm	hot 
warm
varmen	the heat
vask	sink
vasker	washes
vasket	washed
ved	by
ved ikke om	don't know if
vej	road
vejen	the road
vejnavn	road name
vejret	the weather
velfærd	welfare
ven	friend
vend	turn
flip
vender tilbage	returning
vendt tilbage	returned
vendte	turned around
vendte tilbage	retuned
venlig	kind (would you be so kind)
venner	friends
vente	wait
verden	the world
vi ses	see you
vide	know
viden	knowledge
videnskaben	the science
vides	is known
vidste	did know
knew
vigtigheden	the importance
vil	wants
will
want
vil gerne have	would like
vil have	want to have
ville	would
ville have	wanted
villet	wanted
vinden	the wind
vinder	win
vindmøller	windmills
vinduet	the window
vinglasset	the wine glass
virkede	did work
was/were working
worked
virkeligheden	the reality
virker	works (functions)
virksomheden	the company
vis	show
vise	show
vises	will be shown
am/are/is shown
vist	probably
viste	showed
vold	violence
