_____ er illa við (use accusative)	_____ don't like
-unnendur	Lover (eg. book lover)
-Þolin	-resistant
(Ríkis)borgari	Citizen
Á	On top of
Á	River
Á ___ fresti	Every ___ (eg years)
A - aði (talaði); da - ti (henti)	Past tense (tala, handa)
Á ævinni	During the lifetime
Á daginn	During the day
Á hverju ári	Every year
Á hverjum degi	Every day
Á hvolfi	Upsidedown
Á meðan	While
Á meðan	While
Á moti	Against
Á móti / gegn	Against (2)
Á undan / áður	Before (2)
Áberandi	Noticeable
Ábyrgur	Responsible
Ábyrgur	Responsible
Að áætla	To estimate
Að aðskila	To separate
Að aðstaða	To help / assist
Að aðstoða	To assist
Að æla	To vomit
Að æpa / að öskra	To yell (2)
Að æpa / að öskra	To yell (2)
Að æpa / að öskra á	To yell (2)
Að ætlast til að	To expect (someone to do something)
Að afhenda	To deliver
Að afhjúpa	To uncover
Að afla	To gather
Að aflétta	To unload
Að aflýsa / að afboða	To cancel (2)
Að afrita	To copy
Að aftengja	To disconnect
Að ákveða	To decide
Að anda	To breathe
Að anda	To breathe
Að andmæla	To oppose
Að athuga / að gá	To check (2)
Að átta sig á	To realize
Að átta sig á	To realize
Að bæta	To improve / add
Að banka (upp á)	To knock
Að batna / að ná sér	To recover (2)
Að benda	To point
Að berjast	To fight (for something)
Að berjast	To fight for
Að beygja	To bend
Að beygja	To turn
Að bíða	To wait
Að biðja	To ask (someone to do something)
Að bila	To break (down)
Að binda	To tie
Að birtast	To appear
Að bíta	To bite
Að bjarga	To save
Að bjarga	To save (eg. someone)
Að bjóða	To invite / offer
Að blása	To blow
Að borga / Að greiða	To pay (2)
Að borga / greiða	To pay (2)
Að bræða	To melt
Að bræða	To melt
Að bragðast við	To respond (with actions)
Að bregðast við	To respond / react
Að brenna	To burn
Að bretta upp	To roll up
Að breyta	To modify
Að breyta	To modify
Að brjóta	To break
Að brosa	To smile
Að búa um rúmið	To make the bed
Að búa undir / undirbúa	To prepare
Að búast við	To expect (something to happen)
Að búast við	To expect / anticipate
Að búast við (ég býst)	To expect (something to happen)
Að byggja	To build
Að byggja	To build
Að byrja / hefjast	To begin (2)
Að deila	To argue (also to share)
Að deila	To dispute
Að deila / að skipta á milli	To share
Að dekra	To spoil
Að detta í hug	To get the idea
Að draga	To drag
Að draga úr	To reduce
Að drepa	To kill
Að drífa sig	To hurry
Að drukkna	To drown
Að dvelja	To stay
Að efast	To doubt
Að eiga skilið	To deserve
Að eiga skilið	To deserve
Að eiga við	To be relevant
Að eiga von á	To expect
Að einbeita sér að	To focus on
Að elda / að matreiða	To cook (2)
Að elta	To chase
Að elta	To chase
Að endast	To last
Að endast vel	To be durable
Að endurbæta	To rennovate
Að endurnýa	To renew
Að endurspegla	To reflect
Að endurtaka	To repeat
Að endurvinna	To recycle
Að ergja	To irritate
Að éta	To eat (animals)
Að eyða	To spend
Að eyða	To spend
Að eyða	To spend
Að eyðileggja	To destroy
Að eyðileggja	To destroy
Að eyðileggja	To destroy
Að eyðileggja / að rústa	To destroy (2)
Að faðma	To hug
Að fæða	To feed
Að fæðast	To be born
Að fæla	To scare
Að færa	To move
Að falla	To fail (test)
Að fara á hausinn	To go broke
Að fara í taugarnar	To get on one's nerves
Að fatta	To get it
Að fela	To hide
Að ferðast	To travel
Að festa	To fasten / stick
Að feta	To take small steps
Að fikta	To fiddle with
Að finna	To feel (touch ot emotion)
Að finna	To find
Að finna upp	To invent
Að fjalla um	To be about / talk about
Að fjalla um	To talk about
Að fjalla um / að ræða um	To discuss (2)
Að fjara út	Tide going out
Að fjarlægja	To remove
Að fjarlægja	To remove
Að fjölga	To multiply (procreate)
Að fjölga	To multiply / procreate
Að flæða að	Tide coming in
Að flækja	To complicate
Að flækjast	To tangle
Að fletta	To turn the page
Að fletta upp	To look up
Að flokka	To classify / sort
Að flokka	To sort
Að flýja	To escape
Að flýta / að drífa	To hurry (2)
Að flytja	To move (the location)
Að flytja	To move / transport
Að flytja	To perform (also move)
Að fræða	To educate
Að framleiða	To produce
Að fresta	To postpone (indefinitely)
Að fylgja	To follow
Að fylgja	To follow
Að gagnrýna	To criticize
Að ganga frá	To clean up
Að ganga frá	To put away / clean up
Að ganga frá	To sort out
Að ganga til liðs við	To join the team
Að gefa	To give
Að gera árás	To attack
Að gera við	To repair
Að gerast	To happen
Að gerast	To happen
Að geta	To be able to
Að geta	To guess
Að geyma	To keep / store
Að giftast / Að kvænast	To marry
Að giska	To guess
Að gista	To stay (sleepover)
Að gista	To stay overnight
Að gleypa	To swallow
Að glíma	To wrestle
Að glósa	To take notes
Að glósa	To take notes
Að græða	To earn
Að grafa	To dig
Að grafa	To dig
Að gráta	To cry
Að gráta	To cry
Að grípa	To catch
Að gróa	To heal
Að gruna	To suspect
Að hækka	To increase
Að hækka / að aukast	To increase (2)
Að hætta / að slaufa	To quit (2)
Að hafa áhrif	To have influence
Að hafa áhrif	To influence
Að hafa áhyggjur	To worry
Að hafa efni á	To afford
Að hafa fullt vald	To have full control
Að hafna	To reject
Að haga sér	To behave oneself
Að halda áfram	To continue
Að halda áfram	To proceed
Að halda upp á / að fagna	To celebrate (2)
Að halda upp á / að fagna	To celebrate (2)
Að handtaka	To arrest
Að hanga	To hang
Að hangsa	To hang out (wasting time)
Að hanna	To design
Að hanna	To design
Að hefjast	To begin
Að heilsa	To say hi
Að heimsækja	To visit
Að heimta	To demand
Að hella	To pour
Að hemja	To contain
Að herða	To tighten
Að herða	To tighten
Að herma	To copy / immitate
Að herma	To immitate
Að hindra / að koma í veg fyrir	To prevent (2)
Að hindra / að koma í veg fyrir	To prevent (2)
Að hitta / að rekast á	To bump into (eg. at the store) (2)
Að hitta á	To hit (physically, such as a target)
Að hlaða	To charge
Að hlaða	To load
Að hlaða	To load
Að hlæja	To laugh
Að hlæja	To laugh
Að hlakka til	To look forward
Að hlakka til	To look forward
Að hleypa út	To let out
Að hljóma	To sound
að hljóta (ég hlýt, hann hlýtur)	Must
Að hlýða	To obey
Að hnerra	To sneeze
Að hoppa / að stökva	To jump (2)
Að hósta	To cough
Að hósta	To cough
Að hreista	To squeeze
Að hreyfa	To move
Að hreyfa	To move
Að hrista	To shake (something else)
Að hrynja	To collapse
Að hugsa / að halda	To think (2)
Að hverfa	To dissapear
Að hverfa	To dissapear
Að hvessa	To pick up (wind only)
Að hvetja	To encourage
Að hvetja	To encourage
Að hvíla	To rest
Að hvíla	To rest
Að hvísla	To whisper
Að iðka	To do regularly
Að iðka	To do something regularly (eg. sports)
Að jarða	To bury
Að játa	To confess
Að kafa	To dive
Að kafa	To dive
Að kafna	To choke
Að kanna	To explore
Að kasta	To throw
Að kasta	To throw
Að kasta / að henda	To throw (2)
Að kenna um	To blame
Að keyra / að aka	To drive (2)
Að keyra / að aka	To drive (2)
Að kitla	To tickle
Að kitla	To tickle
Að kjósa	To elect / vote
Að klæða sig í	To get dressed
Að klæja	To itch
Að klaga	To complain / tell on
Að klára	To finish
Að klessa á	To crash into
Að klessa á	To crash into
Að klikka á	To make a small error
Að klóra	To scratch
Að klúðra	To screw up
Að koma á óvart	To surprise
Að koma aftur á sporið	To get back on track
Að koma fyrir	To put
Að koma í veg fyrir	To prevent
Að krækja	To hook
Að krefjast	To insist / demand
Að kremja	To crush
Að kunna	To be able to
Að kunna	To know how
Að kura	To cuddle
Að kvarta	To complain
Að kvíða	To dread
Að kvíða	To dread
Að kýla	To punch
Að kyssa / að kela	To kiss (2)
Að labba	To walk
Að lækka	To decrease
Að lækna	To cure
Að laga	To fix
Að laga / að gera við	To fix (2)
Að lána	To loan / borrow
Að láta	To let
Að láta eins og	To act like
Að láta sem ekkert sé	To act like nothing is wrong
Að lauma	To sneak
Að launa	To reward
Að leggja	To put (lay down)
Að leggja á borð	To set the table
Að leggja af stað	To depart
Að leggja sig fram	To put a lot of work in
Að leggja til	To suggest
Að leiða	To guide / lead
Að leiða	To lead
Að leiðast	To hold hands
Að leigja	To rent
að leita að	To search for
Að lenda	To land
Að lenda	To land
Að leyfa	To permit
Að leyfa	To permit
Að leysa	To solve
Að leysa	To solve
Að leysa upp	To dissolve
Að líða	To feel (eg. feel bad)
Að líða	To feel (good/bad)
Að líða yfir	To faint
Að lifa af	To survive
Að lifna við	To come alive
Að liggja	To lie (eg. in bed)
Að liggja	To lie (eg. on the floor)
Að líkjast	To look like
Að líta út (fyrir að vera) / eins og	To look like (adjective or verb) / (noun)
Að ljúga	To lie
Að ljúka	To end
Að ljúka	To finish
Að lofa	To promise
Að losa	To loosen
Að losa sig við	To get rid of
Að losna við	To get rid of
Að lykta	To smell
Að lýsa	To describe
Að lýsa yfir	To announce
Að mæla með	To recommend
Að mæla með	To recommend
Að mætta	To show up
Að máta	To try on
Að máta	To try on
Að máta	To try on
Að meðaltali	On average
Að meiða	To hurt
Að meina	To mean (what do you mean)
Að mestu leiti	Most of the time
Að miða	To aim
Að miða	To aim / target
Að miða við	To compare
Að miða við	To compare
Að minna sig á	To remind someone
Að minnsta kosti	At least
Að mínu mati	In my opinion
Að missa af	To miss out
Að missa móðinn	To give up
Að mistakast / að falla	To fail (2)
Að móðga	To offend
Að moka	To shovel
Að moka	To shovel
Að mótmæla	To protest
Að muna	To remember
Að ná	To catch (eg. In a trap)
Að ná	To pass (eg. test)
Að ná	To reach / pass
Að ná sér	To recover
Að neita	To refuse
Að neita	To refuse
Að neyða	To force
Að njóta	To enjoy
Að njóta	To enjoy
Að nöldra	To nag
Að nöldra	To nag
Að ógna	To threaten
Að óska	To wish
Að óska	To wish
Að óttast	To fear
Að óttast	To fear
Að pæla í	To think about
Að pæla í	To think about
Að panta	To book / order
Að passa	To watch (eg kids)
Að passa	To watch (out - make sure something happens)
Að passa / að gæta	To take care (be careful) (2)
Að plata	To trick
Að plata / að gabba	To trick (2)
Að pússa	To polish
Að pússa / að fægja	To polish (2)
Að pússa / fægja	To polish (2)
Að raða	To arrange (eg. in order)
Að ráða	To control
Að ráða	To control; to hire
Að ráða	To hire
Að raða	To put in order
Að ráða / að stjórna	To control (2)
Að ráða við	To deal with
Að ráða við	To handle
Að ráðast	To attack
Að ráðast á	To attack
Að ráðfæra sig	To consult
Að ráðlega	To advise
Að ræða	To discuss
Að ræða / að fjalla um	To discuss (2)
Að rækta	To grow / breed
Að rækta	To make something grow
Að ræna	To rob
Að ræsa	To start (eg. a race)
Að raka	To shave
Að raka	To shave
Að rata	To know the way
Að reikna	To calculate
Að reikna	To calculate
Að reka	To fire
Að reka	To run (eg. a business)
Að reka augun í	To notice
Að rekast í	To bump into (physically)
Að rekast í	To bump into (physically)
Að renna	To slide
Að renna	To slide
Að renna út	To expire
Að reyna	To try
Að ríða	To ride (animals)
Að rífast	To argue
Að rífast	To argue
Að roðfletta	To skin (eg. fish)
Að rugla	To mess up
Að rugla	To mess up (eg. hair)
Að rugla sig í ríminu	To confuse
Að ryksuga	To vacuum
Að sækja	To pick up
Að sækja / að ná í	To pick up (2)
Að sækja um	To apply
Að sakna	To miss
Að samþykkja	To approve
Að sanna	To prove
Að sannfæra	To convince
Að segja af sér	To resign
Að seinka	To postpone (short time)
Að sekta	To fine
Að semja	To negotiate
Að senda út	To broadcast
Að setja fútt í	To increase the fun
Að setja saman	To combine
Að setjast í helgan stein	To retire
Að sía	To filter
Að sía	To filter
Að siga	To lower
Að sigla	To sail
Að sigra	To win
Að sjá eftir	To regret
Að sjálfu sér	On its own
Að sjóða	To boil
Að sjúga	To suck
Að skafa	To scrape
Að skapa	To create
Að skapa	To create
Að skapa	To create
Að skella sér	To go (joke-y way)
Að skemma	To damage
Að skemma	To ruin
Að skemmast	To spoil
Að skemmta	To entertain
Að skera	To cut
Að skerpa	To sharpen
Að skila	To return
Að skilja eftir	To leave behind
Að skilja útundan	To leave someone out
Að skína	To shine
Að skipta / að breyta	To change / switch (2)
Að skipta á milli	To split between
Að skipta sér af	To get involved
Að skipuleggja	To organize
Að skipuleggja	To organize
Að skjálfa	To shake (if object is shaking, not doind the shaking)
Að skjálfa	To shake (if you are shaking, not doing the shaking)
Að skola	To rinse
Að skoppa	To bounce
Að skorta	To lack
Að skrá	To sign (up)
Að skrá	To sign up
Að skreppa	To pop out
Að skreyta	To decorate
Að skríða	To crawl
Að skrifa undir	To sign
Að skrópa	To skip
Að skulda	To owe
Að slá	To beat
Að slakka á / að slappa af	To relax
Að slást	To fight
Að sleppa	To let go
Að sleppa	To let go
Að sleppa	To let go
Að sleppa	To skip
Að sleppa við	To avoid
Að slíta	To tear (eg. muscle)
Að slökkva	To turn off
Að slúðra	To gossip
Að smakka / að bragða	To taste (2)
Að smakka / bragða	To taste (2)
Að smella	To click
Að smíða	To build (from wood)
Að snerta	To touch
Að snerta	To touch
Að snúa	To turn (or switch)
Að snúa við	To turn around
Að sóa	To waste
Að sóa	To waste
Að sóða út	To make a mess
Að sópa	To sweep
Að spá	To wonder (or predict)
Að sparka	To kick
Að sprauta	To inject
Að sprauta / að úða	To spray (2)
Að spyrja / að biðja	To ask (2)
Að staðfesta	To confirm
Að staðfesta	To confirm
Að stafla	To stack
Að standa í veg	To stand in the way
Að standa sig vel (illa)	To do a good (bad) job
Að standast	To pass
Að stefna að	To head toward
Að steikja	To fry
Að stela	To steal
Að stiga á	To step on
Að stinga	To stab
Að stinga af	To run away
Að stöðva	To stop
Að stökkva	To jump
Að strauja	To iron
Að stríða	To tease
Að stunda	To practice / take part (eg. sports)
Að stunda kynlíf	To have sex
Að styðja	To support
Að styggja	To upset
Að suða	To beg
Að svara	To answer
Að sveifla	To swing
Að sveifla	To swing
Að svíkja	To betray
Að svindla	To cheat
Að sýna	To show
Að tæma	To empty
Að taka _____ í sundur	To take apart
Að taka á móti	To receive
Að taka eftir	To notice
Að taka fram úr	To overtake
Að taka undir	To agree
Að taka upp	To record / harvest
Að taka þátt	To participate
Að takast (mér tókst)	To manage to do something
Að tapa	To lose (eg. game or battle)
Að tefja	To delay
Að tefja	To delay
Að teikna	To draw
Að telja	To count
Að telja	To count
Að tengjast	To connect
Að teygja	To stretch
Að tilheyra	To belong
Að tilkynna	To report
Að tilnefna	To nominate
Að tína upp	To pick up
Að tjá sig	To express oneself
Að toga	To pull
Að togna	To twist
Að troða sér í	To squeeze into
Að trúa	To believe
Að trufla	To interrupt
Að trufla	To interrupt / disturb
Að tyggja	To chew
Að týna (ég týndi)	To lose (I lost) something
Að undirbúa	To prepare
Að undirbúa	To prepare
Að uppfæra	To update
Að uppgötva	To discover
Að upplýsa	To inform
Að urra	To growl
Að útskrífa	To sign out / graduate
Að útskrifast	To graduate
Að útskýra	To explain
Að útvega	To supply
Að valda	To cause
Að valda / að orsaka	To cause (2)
Að vara við	To warn
Að varðveita	To preserve
Að vaxa	To grow (oneself)
Að veðja	To bet
Að veðja	To bet
Að vefja	To wrap
Að vega og meta	To evaluate
Að veiða	To fish (or hunt)
Að veita	To provide
Að veita	To provide
Að vekja	To wake (someone else)
Að vekja hrifningu	To impress
Að velja	To choose
Að velja	To choose
Að velta	To roll
Að velta	To turn over (an object)
Að venjast	To get used to
Að venjast	To get used to
Að vera hluti af	To be a part of
Að vera hrifinn af	To be fond of
Að vera í sama um	To be indifferent about
Að vera klæddur í	To be wearing
Að vera klæddur í	To wear
Að vera orðinn / að verða	To become (2)
Að vera óþekkur	To be misbehaving
Að vera sáttur við	To be ok with
Að vera stoltir	To be proud
Að vera til	To be available
Að vera úr	To be made from
Að verða / að vera orðinn	To become (2)
Að verða viðskila	To become seperated
Að verja	To defend
Að verja	To defend
Að vernda	To protect
Að versla	To shop
Að viðhalda	To maintain
Að vigta	To weigh
Að vigta	To weigh
Að vinna / að sigra	To win (2)
Að virðast	To seem
Að vita	To know
Að vita / að þekkja	To know (2)
að yfirgefa	To leave (depart)
Að ýkja	To exaggerate
Að ýta	To push
Að þagna	To become quiet
Að þegja	To be silent
Að þegja	To be silent
Að þekkja	To know (someone)
Að þéna	To make money
Að þjást	To suffer
Að þjást af	To suffer from
Að þola	To tolerate
Að þora	To dare
Að þora	To dare
Að þrífa / að hreinsa	To clean (2)
Að þróa	To develop
Að þróa	To evolve / develop
Að þröngva	To force (physically)
Að þurfa / að vanta	To need (2)
Að þýða	To translate
Að þykja vænt um	To care about
Að þykjast	To pretend
Að þykjast	To pretend
Aðallega / nokkurn vegin	Mostly (2)
Aðalréttur	Main course
Áðan	Earlier
Aðfangadagur	Christmas Eve
Aðgangur	Access
Aðgerð	Operation / Initiative
Aðstæður	Situation
Æði	Wonderful
Æfingin skapar meistarann	Practice makes perfect
Ætilegur	Edible
Ætli þú hafir haft rétt fyrir þér	I guess you were right
Ævi	Lifetime
Ævintýri	Adventure
Af hverju / hvers vegna	Why (2)
Af og til	Now and then
Af viti	Sense (talk sense)
Af því að / vegna þess	Because (2)
Afbrot	Crime
Afbrýðisamur / öfundsjúkur	Jealous (2)
Áfengi	Alcohol
Afgangur	Leftovers
Afkvæði	Vote (n)
Afkvæmi	Offspring
Afkvæmi	Offspring
Afleiðing	Consequences
Afrek	Achievement
Afskekktur	Isolated
Afsláttur	Discount
Afsökun	Excuse
Aftur	Again
Ágjarnir	Greedy
Ágoði	Proceeds
Áhætta	Risk
Áhrif	Effect
Áhugamál	Hobby
Áhugamál	Hobby
Áhugasamur	Interested
Áhugaverður	Interesting
Ákaflega	Extremely
Akkeri	Anchor
Akkúrat / nákvæmlega / einmitt	Exactly
Álegg	Toppings
Algengur	Common
Algengur	Common
Alheimur	Universe
Álit	Opinion
Allavega / að minnsta kosti	At least / at a minimum (2)
Allt í einu	All of a sudden
Almenningur	The public
Alvarlegur	Serious
Alvarlegur	Serious
Alveg	Totally
Alþjóðlegur	International
Alþjóðlegur	International
Án	Without
Andartak	Moment
Andstæðingur	Opponent
Andstæður (doesn't congigate)	Opposite
Annað kvöld	Tomorrow night
Annað kvöld	Tomorrow night
Annaðhvort	Either
Annars	Otherwise
Áráður	Propaganda
Árangursríkur	Successful (eg. at a task)
Áratugur	Decade
Árekstur	Collision
Árstíð	Season
Árstíð	Season (weather)
Ásætanlegur	Acceptable
Ásættanlegur	Acceptable
Ásigkomulagi	Condition (eg. Good)
Áskorun	Challenge
Asni	Donkey
Ástæða	Reason
Ástand	Situation
Ástfanginn	In love
Átak	Effort
Atburður	Event
Athygli	Attention
Átt	Direction
Áttaviti	Compass
Atvik	Incident
Atvinna	Job
Auðvelt	Easy
Auðvitað / sjálfsagt	Of course (2)
Augljós	Obvious
Augljós	Obvious
Auglýsing	Advertisement
Auka	Extra
Aukaverkanir	Side effects
Auli	Wimp
Aumur	Weak
Aumur	Weak
Ausa	Ladel
Baðkari	Bathtub
Bæklingur	Pamphlet
Baka	Pie
Bara / aðeins	Only (2)
Barátta	Fight
Barnhelt	Childproof
Bás	Booth
Bein	Bone
Beinagrind	Skeleton
Bekkur	Bench
Bekkur	Grade (in school)
Benslaband	Ziptie
Bergmál	Echo
Beygður	Bent
Biðröð	Lineup
Biðröð	Lineup
Bikar	Trophy
Bil	Gap
Bílastæði	Parking lot
Bílastæði	Parking lot
Bílskúr	Garage
Bílslys	Car accident
Bjalla	Bell / beetle
Bjarg	Cliff
Bjartsýnir	Optimistic
Bjartur / skær	Bright (2)
Björgunarsveit	Search and rescue
Björn	Bear
Blankur	Broke
Blautur	Wet
Bleikja	Char (fish)
Blek	Ink
Blessaður vertu	Don't worry about it
Blettur	Spot
Blikna	Pale
Blindur	Blind
Blóð	Blood
Blómkál	Cauliflower
Blýantur	Pencil
Blýantur	Pencil
Boginn	Bent
Bolur	Shirt
Bölva	Curse
Bóndi	Farmer
Borðstofa	Dining room
Botn	Bottom
Bráðatæknir	Paramedic
Bráðum	Soon
Bragð	Flavour
Brak	Crack (sound)
Brálaður	Angry / crazy
Bratt	Steep
Bratt	Steep
Braut	Track (eg. race track)
Bréf	Letter
Breiður	Wide
Breiður	Wide
Brella	Trick (n)
Bremsur	Brakes
Bretti	Board (eg. skate, snow)
Brjálaður	Crazy / angry
Brotaþoli	Victim
Bröttför	Departure
Brú	Bridge
Brú	Bridge
Brúða	Puppet
Brún	Edge
Bryggja	Dock / Pier
Brýnt	Urgent
Búkki	Jack stand
Búnaður	Equipment
Búnaður	Equipment
Búningsklefi	Change room
Búningur	Costume
Byrjandi	Beginner
Býsna	Pretty (eg. pretty cool)
Býsna	Pretty (eg. pretty good)
Býsna / ansi	Pretty (eg. pretty good) (2)
Byssa	Gun
Condition	Ástand
Dæmi	Example
Dagatal	Calendar
Dagskrá	Schedule
Dálítið	A little bit
Dálítið / svolítið	A little bit (2)
Dalur	Valley
Dapur	Sad
Dapur / leiður	Sad (2)
Dásamlegur	Wonderful
Dauður	Dead
Deild	Division / section
Djöfull	Devil
Djúpur	Deep
Dofinn	Numb
Dómgreind	Judgement (eg good)
Dónalegur	Rude
Dónalegur / ruddalegur	Rude (2)
Dós	Can
Dós	Can (n)
Drasl	Junk / mess
Draugur	Ghost
Drulla	Shit / mud
Dúkka	Doll
Dvalarleyfi	Residency
Dýr	Animal
Eða eitthvað svoleiðis	Or something like that
Efni	Chemical or material
Efnilegur	Promising
Efri	Upper
Eftirlit	Supervision
Eftirréttur	Dessert
Ég / mig / mér	I (3 cases)
Ég ætti / þú ættir / við ættum	I / you / we should
Ég er að því	I am doing it
Ég er búinn að vera	I have been
Ég er sammála	I agree
Ég gæti	I could
Ég myndi	I would
Ég sé ekki rassgat	I don't see anything
Ég vissi	I knew
Eggaldin	Eggplant
Eilífu	Forever
Einfaldur	Simple
Einhleypur	Single
Einhvers konar	Any kind of
Einmana	Lonely
Einn	Alone
Einn / ein / eitt	One (3)
Einstakur	Unique
Einu sinni enn	One more time
Eitraður	Poisonous
Eitur	Poison
Ekki síst af	Not least of which
Ekta	Authentic
Él	Hail
Eldgos	Erruption
Eldhús áhöld	Dishes
Eldur	Fire
Endur	Ducks
Endur-	Re-
Engill	Angel
Enginn	No one
Enginn	No one
Enginn / ekki neinn	No one (2)
Enginn vafi	No doubt
Ennþá	Still
Erfitt	Difficult
Erilsamur	Busy (busy place)
Ertu viss	Are you sure?
Eyja	Island
Faðir	Father
Fær	Good (at an activity)
Fætur	Feet
Fagmaður	Professional (n)
Fáir	Few
Fallhlíf	Parachute
Fangelsi	Prison
Farangur	Luggage
Farangur	Luggage
Farðu varlega / passa þú þig	Be careful
Fastefni	Solid (matter)
Fata	Bucket
Fátækur	Poor
Fatahengi	Closet
Fatlaður	Disabled (physically)
Fáviti	Retarded
Feginn	Glad / releived
Feiminn	Shy
Félag / samtök	Organization (2)
Félagi	Partner
Félagslyndur	Social
Ferðamaður	Tourist
Ferhyrningur	Square
Ferhyrningur	Square
Ferill	Career
Ferlegur	Awful
Ferlegur / hræðilegur	Horrible (2)
Ferskja	Peach
Ferskur	Fresh
Fiðrildi	Butterfly
Fífl / kjáni / heimskingi	Fool (3)
Fimleikar	Gymnastics
Fínn	Fancy
Fínn	Fancy
Fjara	Low tide
Fjárfestingabanki	Investment bank
Fjársjóður	Treasure
Fjársjóður	Treasure
Fjàrsóður	Treasure
Fjarstýring	Remote control
Fjölbreyttur	Varied
Fjölbreyttur	Varied / diverse
Fjöldi	Many
Fjölmiðlar	Media
Fjölskylda	Family
Fjölskylda	Family
Fjólublár	Purple
Fjórir / fjórar / fjögur	Four (3)
Fleira	More (countable)
Fleki	Raft
Fljótur	Quick
Flóð	High tide
Flókinn	Complicated
Flökurt	Nausious
Fógeti	Sheriff
Foreldra	Parent
Formlegur	Official
Forréttur	Appetizer
Forrit	Program (computer)
Forsætis Ráðherra	Prime Minister
Forseti	President
Forstjóri	CEO
Forstofa	Entry hall
Forvitinn	Curious
Föt / Fatnaður	Clothing (2)
Fótspor	Footsteps
Frá grunni	From scratch
Fræ	Seeds
Fræði	Study of
Fræðingur	Researcher / specialist
Frægur	Famous
Frægur	Famous
Frændi	Cousin / relative (male)
Frænka	Aunt or relative
Frálsar	Track and field
Fram í	Ahead of
Framandi	Exotic
Framburður	Pronunciation
Framfarir	Progress
Framkoma	Behaviour
Framkvæmdir	Construction
Framleiðandi	Manufacturer
Framrúða	Windshield
Framtíð	Future
Freistandi	Tempting
Frekar	Rather
Frekur	Demanding
Fréttamaður	Reporter
Friður	Peace
Frjáls	Free (eg. freedom)
Frjáls	Free (ie. freedom)
Fróður	Knowledgeable
Frum-	First (prefix)
Frumlegur	Original
Frumlegur	Original (eg. music)
Fullkominn	Perfect
Fundi	Meeting
Furðufugl	Weirdo
Furðulegur	Amazing
Furðulegur / skrítinn	Weird (2)
Fyndinn	Funny
Fyrir aftan	Behind
Fyrir framan	In front of
Fyrir útan	Outside
Fyrirgefðu	Sorry (done something wrong)
Fyrirlestur	Lecture
Fyrirliði	Captain (of a team)
Fyrirmynd	Role model
Fyrrverandi	Former
Fyrrverandi	Former / ex
Gæði	Quality
Gæludýr	Pet
Gáfur	Brains
Gagnlaus	Useless
Gagnlegur	Useful
Gagnlegur	Useful
Gagnlegur / hentugur	Useful (2)
Gagnlegur / nytsamlegur	Useful (2)
Gagnsær	Transparent
Gagnslaus / einskis nýtur	Useless (2)
Gagntekinn	Obsessed
Galdrar / Töfrar	Magic (2)
Gallaður	Defective
Galopinn	Wide open
Gamall / Eldri / Elstur	Old / Older / Oldest
Gaman / fjör	Fun (2)
Gangstétt	Sidewalk
Gangur	Hallway
Gasefni	Gas
Gat	Hole
Gatnamót	Intersection
Gaur	Dude
Geggjaður	Crazy
Geirvarta	Nipple
Geisladiskur	CD
Gervi	Artificial
Getur þú minnt mig á	Can you remind me
Geymir	Tank (eg. of water)
Gígur	Crater
Gikkur	Fussy (about food)
Gil	Gully
Gildra	Trap (n)
Gír	Gear
Girðing	Fence
Girðing	Fence
Glæpamaður / bófa	Criminal / crook (2)
Glæpamaður / bófi	Criminal / crook (2)
Glæpur	Crime
Glæpur	Crime
Góð vörn	Good defence
Góðgæti	Goodies
Góðgerðamál	Charity
Gögn	Data
Gólf	Floor
Göng	Tunnel
Gormar	Spring (metal)
Gormar	Spring (not season)
Gos	Soda
Gráðugur	Greedy
Gráður	Degrees
Græjur	Stereo
Gráhærður	Grey head
Grasker	Squash
Greiða	Comb
Greiði	A favour
Grein	Article
Greinilega	Clearly
Greinilega / klárlega	Clearly (2)
Gretta	Frown
Gríma	Mask
Grimmur	Mean
Grín	Joke
Grind	Frame
Gripi	Treasure
Grófur	Rough / coarse
Grunnur	Shallow
Grunnur	Shallow
Gufa	Steam
Hæð	Floor (eg. 2nd)
Hæfileiki	Talent
Hægara sagt en gert	Easier said than done
Hægt	Possible
Hægt / mögulegt	Possible (2)
Hægur	Slow
Hægur	Slow
Hættu þessu	Stop it
Hættulegur	Dangerous
Hættulegur	Dangerous
Hagnaður	Profit
Hálendi	Highlands
Hálfur	Half (of one)
Hálka	Black ice
Hálka	Slippery
Háll	Slippery
Hallærislegur	Lame (dorky)
Háls	Neck
Háls	Neck
Hamagangur	Chaos
Hámark	Maximum
Hamingju	Happiness
Handa mér/þér	For me/you
Handrit	Script
Hanskar / Vetlingar	Gloves (2)
Hápunktur	High point
Hár / hærri / hæstur	High / higher / highest (or tall)
Harður	Hard (not difficult)
Harður / Harðari / Harðastur	Hard / Harder / Hardest
Hátalari	Speaker
Hátíð	Festival
Háttatími	Bedtime
Hauskupa	Skull
Hávaði	Noise
Hávaði	Noise
Hávær	Loud
Hávaxinn	Tall (person)
Hefð	Tradition
Hefnd	Revenge
Heiðarlegur	Honest
Heiðvirður	Honorable
Heilahristing	Concussion
Heili	Brain
Heill	Whole
Heillandi	Charming
Heimild	Credit limit (also source, eg. newspaper)
Heimilisfang	Address
Heimsálfa	Continent
Heimskulegt	Stupid (eg bad idea)
Helli	Cave
Helmingur	Half (of many)
Heppinn	Lucky
Her	Army / military
Hérna / hingað	Here (stationary/moving)
Hetju	Hero
Heyrnartól	Headphones
Hiksta	Hiccups
Hilla	Shelf
Himinn	Sky
Hinsvegar	On the other hand
Hissa	Surprised
Hitamælir	Thermometer
Hjálplegur	Helpful
Hjátrúafullur	Supersticious
Hjón	Married couple
Hlátur	Laughter
Hlé	Intermission
Hleðsla	Charge (battery)
Hleðslutæki	Charge device
Hlið	Side (physical object)
Hljóðfæri	Instrument
Hljóðlátur	Quiet
Hljóðlátur / þögull	Quiet (2)
Hljóðnemi	Microphone
Hljómsveit	Band
Hlómar vel	Sounds good
Hlutlaus	Neutral
Hlutur	Thing / Part
Hlý	Warm
Hnífapör	Utensils
Höfn	Harbour
Höfuðverkur	Headache
Hóll	Hill
Hollur / heilbrigður / hraustur	Healthy (3)
Hönd / hendur	Hand / hands
Hönnun	Design (n)
Hópur	Group
Hópur	Group
Horaður	Skinny
Horfinn	Dissapeared
Hörkuvinna	Hard work
Hörkuvinna / puð	Hard work (2)
Hörmung	Disaster
Horn	Corner
Hraðbanki	ATM
Hræðilegur	Horrible
Hrár	Raw
Hraun	Lava
Hraun	Lava
Hreiður	Nest
Hreimur	Accent
Hreinn	Clean
Hringur	Circle
Hringur	Circle
Hrós	Compliment
Hrukkur	Wrinkles
Hryðjuverk	Terrorism
Hryggur	Spine
Húð	Skin
Húð	Skin
Hugrakkur	Brave
Hugsanlega	Possibly
Humlaður	Hoppy
Hunang	Honey
Húsgögn	Furniture
Húsgögn	Furniture
Hvað er að þér (því)	What's wrong with you (it)
Hvað gerðist / hvað kom fyrir	What happened (2)
Hvaða vitleysa	What nonsense
Hvaðan	From where
Hvaðan	Where from
Hvalur	Whale
Hvar sem er	Wherever
Hver	Hot spring
Hver	Hot spring
Hvergi	Nowhere
Hvergi	Nowhere
Hvernig dirfist _____	How dare ______
Hvernig gengur þetta fyrir sig	How is this going to work
Hvers konar	What kind
Hvert	Where to
Hvervi	Neighborhood
Hvíður	Gust
Hvítlaukur	Garlic
Hvorki / hvorugt	Neither (2)
Hvort ég ætla	You know it (I am going to)
Hvort sem er	Either way
Hvorugt	Neither
Hylki	Capsule
Í ætinni	In the family
Í alvöru	For real
Í bili	For now
Í bili	For now
Í birtingu	Dawn
Í boði	Offered
Í burtu	Away
Í byrjun	At the beginning
Í flýti	In a hurry
Í fýlu	Sulking
Í fyrra	Last year
Í fyrra	Last year
Í fyrra dag / sumar / etc.	Day before yesterday / last summer / etc.
Í fyrramálið	Tomorrow morning
Í gær kvöldi	Last night
Í gegnum	Through
Í gegnum	Through
Í gegnum tíðina	Over the years
Í klandri	In trouble
Í kringum	Around
Í lokin	In / at the end
Í samband(i)	Union (also connected)
Í staðinn	Instead
Í stuði	Having fun
Í tæka tíð	In time
Í takt	In sync
Í tísku	In style
Illur ræðari kennir árinni	Bad rower blames the ores
Illur viðskiptis	Hard to deal with (person)
Infæddur	Local
inni í	Inside
Innifalin	Included
Inniskór	Slippers
Íþrótt	Sport
Jafn	Equally
Jafnrétti	Equal rights
Jákvæður	Positive
Jákvætt	Positive
Jarðarför	Funeral
Jarðskjálfti	Earthquake
Járn	Iron
Kafli	Chapter
Kaldhæðinn	Sarcastic
Kalkúnn	Turkey
Kampavín	Champagne
Kapall	Cable
Karfa	Basket
Kartöflur	Potatoes
Keppni	Tournament
Kerfi	System
Kerra	Trailer
Kerra	Trailer
Kista	Chest (to put stuff in)
Kjáni	Fool
Kjáni / fífl	Fool (2)
Kjarn-	Nuclear
Kjarni	Core
Kjóll	Dress
Klaki	Ice
Klandur	Mess
Klár	Intelligent
Klár / gáfaður	Intelligent (2)
Klettur	Rock (big)
Klistraður	Sticky
Klútur	Cloth
Knattspyrna	Football
Koltvýsúringur	Carbon dioxide
Komandi	Upcoming
Könnun	Survey
Kór	Choir
Kosning	Election
Kostir og gallar	Pros and cons
Krá	Bar
Kraftaverk	Miracle
Krani	Faucet
Krefjandi	Challenging
Kreppa	Crisis
Krókur	Hook / hitch
Krummiskuð	Crappytown
Krydd	Spices
Kúl / sniðugur	Cool (2)
Kúla	Ball
Kúla	Ball
Kulnun	Burnout
Kúrbítur	Zucchini
Kurteis	Polite
Kvef	Cold (eg. sick)
Kvensjúkdómalæknir	Gyneacologist
Kvíði	Anxiety
Kvíðinn	Nervous
Kvöldmatur / kvöldverður	Dinner (2)
Kvóti	Quota
Kynslóð	Generation
Kynslóð	Generation
Kyrr	Still (be still, or weather)
Kyrr	Still (not moving)
Lærlingur	Trainee
Læst	Locked
Læstur	Locked
Læti	(Loud) noise
Lag	Layer
Lag/söngur	Song
Lágmark	Minimum
Landamæri	Border
Landbúnaður	Agriculture
Landslið	National team
Langbest	Second to none
Lás	Lock
Láttu ekki svona	Don't be like this
Latur	Lazy
Laun	Salary
Laus	Loose
Lávaxinn	Short (person)
Leið	Way
Leiðbeiningar	Instructions
Leiddist þér	Are you bored?
Leiðsögumaður	Guide
Leiðtogi	Leader
Leigubíll	Taxi
Leikari	Actor
Leikfang	Toy
Leikrit	Play
Leikvöllur	Playground
Lélegur	Lame / poor quality
Letihaugur	Lazy bones (n)
Léttur	Light (weight)
Lexía	Lesson
Leyndarmál	Secret
Leyni	Secret (adj.)
Leyniorð / Aðgangsorð	Password (2)
Líffræði	Biology
Lífrænn	Organic
Líkami	Body
Líkan	Model
Líkbíll	Hearse
Líklega / ábyggilega	Probably (2)
Líklega / ábyggilega / áreiðanlega	Probably (3)
Líklega / Sennilega	Probably (2)
Límona	Lime
List	Art
Lítill / minni / minnstur	Small / smaller / smallest
Litur	Color
Litur	Colour
Ljóðskáld	Poet
Ljótur	Ugly
Ljúfur	Sweet (not taste)
Lóð	Weights
Loðinn	Hairy
Loft	Air
Lofthjúpur	Atmosphere
Loftslag	Climate
Loftvag	Barometer (air scale)
Logandi	Flaming
Logn	Calm (weather)
Lögregla / Löga	Police / cop
Lok	Lid
Loksins	Finally
Lýðveldi	Democracy
Lyf	Drugs
Lyfseðill	Prescription
Lykt	Odour
Malarvegur	Gravel road
Málband	Tape measure
Malbik	Pavement
Málefni	Issue
Málfræði	Grammar
Málið	The the (to be doing)
Málmur	Metal
Málmur	Metal
Málning	Paint
Málverk	Painting
Margir	Many
Margir / fleiri / flestir	Many / more / most (countable)
Margoft	Repeatedly
Mark	Goal; objective
Marktækur	Reliable
Martröð	Nightmare
Matarlyst	Appetite
Matseðill	Menu
Með / hjá	With (2)
Með allt á hreinu	Know it all (nice)
Með ofnæmi fyrir	Allergic to
Með þráhyggja	Obsessed
Meðaltar	Average
Meðlimur	Member
Meðvindur	Tailwind
Meira	More (not countable)
Meirihluti	Majority
Meistari	Champion
Mengun	Pollution
Mengun	Pollution
Menntaskóli	Highschool
Mér finnst _____ góður / mér líst á _____	I like (2)
Mér líður vel / illa	I feel good / bad
Mér sýnist	It looks to me
Merkilegur	Remarkable
Merkilegur	Remarkable
Met	Record (eg world record)
Miðbær	Downtown
Miði	Ticket
Miðstöð	Central heating
Mikill / meiri / mestur	Much / more / most (not countable)
Mikilvægur	Important
Mikilvægur	Important
Milljarður	Billion
Minn eigið	My own
Mis-	Various (eg. Lengths)
Mislyndir	Moody
Mistök	Mistake
Mitti	Waist
Mjöðm	Hip
Mjór	Narrow
Mjúkur	Soft
Motta	Rug (also mustache)
Munnurinn á	The difference between
Myndarlegur	Handsome
Myndband	Video
Myrkur	Dark (time of day)
Nærbuxur	Underwear
Nærri / nálægt	Close / near (2)
Næstum því / nánast	Almost (2)
Nafnorð	Noun
Nágranni	Neighbour
Nákvæmur	Accurate
Nákvæmur	Exact
Nálægur / nærri	Close to (2)
Nám	Education
Náma	Mine (eg. gold)
Nammi	Candy
Námskeið	Course
Nashyrningur	Rhinoceros
Náttúra	Nature
Nauðsynlegur	Necessary
Náungi	Guy
Nautgripir	Cattle
Neðri	Lower
Nefnd	Committee
Nefnifall	First case
Neikvæður	Negative
Nema	Except
Nemi	Intern
Nesti	Food (that you take with)
Neyð / neyðarástand	Emergency (situation)
Neyðar-	Emergency
Niður	Down
Niðursoðnir	Canned
Niðurstaða	Result
Nirfill	Cheapskate
Nokkrir	A few
Nokkurn veginn	Mostly
Norn	Witch
Notalegur	Pleasant
Nútíð	Present (tense)
Nýverið / undanfarið	Recently / lately (2)
Öðruvísi	Different
Of/van-meta	Over / underestimate
Ófær	Unable
Ofan í	Into (from above)
Ofbeldi	Violence
Ofbeldi	Violence
Ófrískur	Pregnant
Oft / venjulega / yfirleitt	Usually (3)
Öfugur / á röngunni	Insideout (2)
Öfundsjúkur	Envious
Öfundsjúkur / Afbreiðasamur	Jealous
Ofur	Super
Ógeðslegur	Disgusting
Óglatt	Nautious
Ógurlegur	Big (and a bit scary)
Óhefðbundinn	Unorthadox
Ókeypis	Free (no cost)
Ökkli	Ankle
Ókunnug	Stranger
Ókyrrð	Turbulence
Öld	Century
Öldur	Waves
Ólétt	Pregnant
Ómeiddur	Uninjured
Ómetanlega	Priceless
Ómissandi	Essential
Ómögulegt	Impossible
Ömulegt	Sucky
Ónýtt	Ruined
Opinber	Public
Örbylgjuofn	Microwave
Orðaforði	Vocabulary
Orðatiltæki	Expression
Örlátur	Generous
Örmagna	Exhausted
Örugger / óhultur	Safe (2)
Öruggur	Safe
Öruggur	Safe
Örvæntingafullur	Desperate
Orval	Selection
Ósköp	Emphasis word
Ósýnilegur	Invisible
Ótrúlegur	Incredible
Óvenjulegur	Unusual
Óviljandi / óvart	Accidentally
Óviljandi / óvart	By accident (2)
Öxl	Shoulder
Óþolinmóður	Impatient
Padda	Bug
Pallur	Terrace / deck
Pappi	Cardboard
Peninga / fé	Money (2)
Píparsveinn	Bachelor
Píper	Pepper
Pirraður	Frustrated
Pláss	Space
Plástur	Band-aid
Plokkari	Tweezer
Plöntur	Plants
Pottþétt	Definitely
Pottþéttur	Reliable (eg person)
Próf	Exam
Púði	Pillow
Putti	Finger
Ráðgefandi	Consultant
Ráðgjafi	Consultant
Ráðgjöf	Advice
Rækja	Shrimp(s)
Ræstitæki	Cleaning device
Rafhlaða	Battery
Rafmagn	Electricity
Raftæki	Electronics
Rakur	Humid
Ranghverfur	Insideout
Rannsókn	Investigation
Raspur	File (tool)
Raunveralegur	Real
Refsing	Penalty
Regla	Rule
Regnbogi	Rainbow
Regnhlíf	Umbrella
Reiður	Angry
Reikistjarna	Planet
Reikningur	Cheque
Reimar	Laces
Reipi	Rope
Rennibraut	Slide
Rennilás	Zipper
Reyndar	Actually
Reyndar / raunverulega	Actually (2)
Reynsla	Experience
Reynsla	Experience
Ríkisborgararéttur / Ríkisfang	Citizenship (2)
Ríkisborgari	Citizen
Ríkisstjórn	Government
Rím	Rhyme
Risaeðla	Dinosaur
Risi	Giant
Ritgerð	Essay
Rithöfundur	Writer
Rök	Argument
Rómur / rödd	Voice (2)
Rosalega / virkilega	Really (2)
Rotaður	Unconscious
Ruglaður	Confused
Rúmlega	Just more than
Rúta	Bus
Rýð	Rust
Ryk	Dust
Sæmilegur	(Barely) ok
Sæti	Place (1st, 2nd)
Sæti	Seat
Sætur	Cute
Safn	Museum
Sagnorð	Verb
Samfélag	Community
Samfélagsmiðill	Social media
Samgöngur	Transportation
Samningur	Contract
Samskipti	Communication
Samtök	Association
Samtök / félag	Organization (2)
Samviskubit	Guilty conscience
Sanngjarn	Fair
Sanngjarnir	Fair
Sannur	True
Sár	Wound
Sársauki	Pain
Satt	Truth
Satt / Sannleikur	Truth (2)
Seigur	Persistent
Seinlegt	Time consuming
Seinn	Late
Sem betur fer	Fortunately
Sem betur fer	Fortunately
Sér	Oneself
Sérfræðingur	Expert
Sérstaklega	Especially
Sérstakur	Special
Síða	Page
Síður	Long (eg. hair)
Síður	Not (like ekki, more polite)
Sigbelti	Harness
Sigurvegari	Champion
Silungur	Trout
Sinnum	Times (how many times)
Sjaldan	Rarely
Sjálfbær	Sustainable
Sjálfbóðaliði	Volunteer
Sjálfsagt	Of course
Sjálfsagt / auðvitað	Of course (2)
Sjálfstæður	Independent
Sjálfstæður	Independent
Sjálfur	On its own
Sjáumst / vertu sæll (stay happy) / heyrumst (on the phone)	Bye (3)
Sjóður	Fund
Sjór	Sea (eg. seaman)
Sjúkdómur	Disease
Skæri	Scissors
Skák	Chess
Skál	Bowl
Skáli	Cabin
Skammdegisþunglyndi	Short-day sickness
Skammtur	Portion
Skap	Mood
Skapaðan hlút	Things that have been discussed
Skapandi	Creative
Skapgóður	Well-behaved
Skattur	Tax
Skeið	Spoon
Skemmdur	Damaged
Skíðastafir	Ski poles
Skilaboð	Message
Skilinn	Divorced
Skilríki	ID
Skilti	Sign
Skiptir ekki máli	Nevermind
Skítugur	Dirty
Skjal	Document
Skjaldbaka	Turtle
Skjár	Screen
Skjól	Shelter
Skoðun	Opinion
Skoðun / álit	Opinion (2)
Skoðun / eftirlit	Inspection (2)
Skófla	Shovel
Skógur	Forest
Sköllóttur	Bald
Skömmustulegur	Embarrassed
Skömmustulegur / neyðarlegur	Embarrassing (2)
Skorpa	Crust
Skott	Trunk (of car)
Skrámur	Cuts
Skrímsli	Monster
Skrítinn	Weird
Skrúfjárn	Screwdriver
Skrúfjárn	Screwdriver
Skrúflykill	Wrench
Skrúfstykki	Vice (tool)
Skúffa	Drawer
Skuggi	Shadow
Skurður	Cut
Skyggni	Visibility
Skýjað	Cloudy
Skyndibiti	Fast food
Skyndihjálp	First aid
Skyndilega	Suddenly
Skynsamur	With common sense
Skýr	Clear (eg. directions)
Skýrsla	Report
Skyrta	Dress shirt
Slagsmál / barátta	Fight (2)
Slakkur	Relaxed
Slanga	Hose
Slanga	Snake
Slasaður / Meidur	Injured (2)
Sléttur	Smooth
Sléttur	Smooth
Slitinn	Worn out
Slitrótt	Intermittent
Slúður	Gossip
Slys	Accident
Smekklegur	Snazzy
Smekklegur / viðhæfi	Appropriate (2)
Snemma	Early
Sniðugur / snjall	Clever (2)
Snjall	Clever
Snjallsími	Smartphone
Snjóskafl	Snow pile
Snögglega	Suddenly
Snyrtilegur	Tidy
Sóðalegur	Messy
Sofandi	Asleep
Sokkar	Socks
Söngvari	Singer
Sorglegur	Sad (eg sad movie, sad sight)
Spá	Forecast
Spaði	Racket
Spæjari	Detective
Spakur	Tame
Spegill	Mirror
Spenntur	Excited
Spes	Weird
Sprækur	Lively
Spræna	Stream
Sprauta	Spray bottle / syringe
Sprengja	Bomb
Sprenglærður	Well-edicated
Sprettur	Sprint
Sprunga	Crevace
Staða	Position
Staðan	Situation
Staðráðinn	Determined
Stærð	Size
Stærðfræði	Mathematics
Stafrænn	Digital
Stafrót	Alphabet
Stafur	Letter
Stafur	Letter
Stanslaus	Non-stop
Stefna	Policy
Stefnuljós	Turn signal
Stefnumót	Appointment
Steinn	Stone
Stífla	Dam
Stig	Degree / points / stages in life
Stigi	Stairs
Stígur	Path
Stilling	Setting
Stjórnmálamaður	Politician
Stofa	Living room
Stofnaður	Founded
Stór / stærri / stærstur	Big / bigger / biggest
Stórkostlegur	Fabulous
Stórmarkaður	Supermarket
Strákur / drengur / piltur	Boy (3)
Strax	Immediately
Streita	Stress (n)
Strönd	Beach
Stýri	Steering wheel
Styrjöld / stríð	War
Stytta	Statue
Sulta	Jam
Sumir	Some
Sundskýla	Swimming trunks
Svæði	Area
Svalir	Balcony
Svalir	Balcony
Svampur	Sponge
Svartsýnir	Pessimistic
Svefnherbergi	Bedroom
Sveit	Countryside
Svið	Stage
Svínvirkar	Works like a charm
Svipað / líkur	Similar (2)
Svipaður	Similar
Sviti	Sweat
Svona	Like (this)
Syfjaður	Sleepy
Sýning	Show / exhibition
Sýnishorn	Preview
Systkini	Siblings
Tæki	Device
Tækifæri	Opportunity
Tæplega	Barely
Tærnar	Toes
Táfýla	Bad smelly toes
Tagl	Tail
Taka _____ í gegn	To overhaul
Takk fyrir farið	Thanks for the ride
Takki / Hnappur	Button (2)
Tár	Tears
Taugaóstyrkur	Nervous
Tekjur	Income
Tengda-	-in law
Tenging	Bond
Tennur	Teeth
Teppi	Blanket
Teppi	Carpet
Til ama	Nuisance
Tilefni	Occasion
Tilefni	Occasion
Tilfelli	Case (eg. medical)
Tilfinning	Feeling
Tilgangslaus	Pointless
Tillaga	Proposal
Tilraun	Experiment
Tímabil	Season (eg sports)
Tímabil	Time period / season
Tímabundinn	Temporary
Tímabundinn	Temporary
Tímarit	Magazine
Tímastillir	Timer
Timbur	Wood
Tindur	Summit / peak
Tíska	Fashion
Tjón	Damage
Töfrar	Magic
Tognaður	Stretched / strained
Tónleika	Concert
Torfæra	Offroad
Torfæra	Offroad
Tré	Tree
Trefill	Scarf
Trefill	Scarf
Trefjaplasti	Fiberglass
Tromma	Drum
Tröppur	Stairs
Trúður	Clown
Tryggingar	Insurance
Tungl	Moon
Tungl	Moon
Tunna	Barrel
Tuska	Rag
Tuskudýr	Stuffed animals
Tveir / tvær / tvö	Two (3)
Tvíburar	Twins
Tvisvar	Twice
Tyggjó	Gum
Ugla	Owl
Ull	Wool
Ull	Wool
Ulnliður	Wrist
Úlnliður	Wrist
Um kvöld (á kvöldin)	At night (2)
Um leið	At the same time
Um leið og	As soon as
Um morgun / Á morgnanna	In the mornings (2)
Um það bil	Approximately
Um það bil / sirka	Approximately (2)
Umburðarlyndur	Tolerant
Umferð	Traffic
Umferð	Traffic
Umhugað	Concerned
Umhverfi	Environment
Ummæli	Comments
Umræða	Discussion
Undanfarið	Lately
Undanúrslit	Semi-finals
Undir áhrifum	Under the influence
Unglingur	Teenager
Uppfinning	Invention
Upplýsingar	Information
Uppnámi	Upset
Uppnámi	Upset
Uppskurður	Surgery
Uppvakninga	Zombie
Úr	Watch
Úrkoma	Precipitation
Úrslit	Finals
Út um allt	Everywhere
Útgangur	Exit
Útilega	Camping
Útilega	Camping
Útsýni	View
Útvarp	Radio
Vængur	Wing
Vald	Power (eg. political)
Valkostur	Option
Vandamál	Problem
Vanur	Used to
Varanlegur	Permanent
Varir	Lips
Varla	Barely
Varlega	Carefully
Varúð	Caution
Vasaljós	Flashlight
Vasi	Pocket
Vaskur	Sink
Vefsíða	Website
Vegabréf	Passport
Veggur	Wall
Vegur	Road
Veiðistöng	Fishing pole
Veikur	Sick
Veisla	Feast
Veisla	Party
Veisla / boð	Party (2)
Vekjaraklukka	Alarm clock
Vel varið	Good save
Vélrum	Engine bay
Venjulegur	Ordinary
Venjulegur / Eðlilegur	Normal (2)
Ventill	Valve
Verði þér að góðu	You're welcome
Verðlaun	Award
Verðmæti	Valuable
Verðmæti	Valuables (noun)
Verðmætur / dýrmætur	Valuable (2)
Verðmætur / dýrmætur	Valuable (2) - adjective
Verkefni	Project
Verkefni	Project
Verkfæri	Tools
Verkfæri / tól	Tool (2)
Verkfall	Strike
Verkfall	Strike
Verkfræðingur	Engineer
Verkjatöflur	Painkillers
Vertu stilltur	Behave yourself
Vesen	Hassle
Veski	Wallet
Við hliðina á	Next to
Víða	All over
Viðbót	Additional
Viðburður	Event
Viðeigandi	Appropriate
Viðkvæmur	Sensitive
Viðskipti	Business
Viðtal	Interview
Viljandi	On purpose
Villtur	Lost
Villtur	Lost
Villtur	Wild (or lost)
Vínekra	Vinyard
Vingjarnlegur	Friendly
Vingjarnlegur	Friendly
Vinsæll	Popular
Vinsamlegast	Please
Vír	Wire
Virðing	Respect
Vísbending	Clue
Vísbending	Evidence
Vísindi	Science
Víst	Apparantly
Víti(skót)	Penalty shot
Vitlaus	Stupid / wrong
Vitlaus / heimskur	Stupid (2)
Vöðvi	Muscle
Vökvi	Liquid
Vondur / slæmur	Bad (2)
Vondur / verri / verstur	Bad / worse / worst
Vonlaus	Hopeless
Vonsvikinn	Dissapointed
Vonsvikinn	Dissapointed
Vopn	Weapon
Vörubíll	Truck (big one)
Vörur	Products / supplies
Vörur	Supplies
Yfir sjávarmáli	Above sea level
Ýfirleitt	Most of the time
Ýmislegt	Various
Þá	Then
Þá / síðan	Then (2)
Það borga sig	It pays off
Það er ekki þess virði	It's not worth it
Það fer eftir því	It depends
Það hlýtur að vera	It must be
Það skaðar ekki	It couldn't hurt
Það skiptir ekki máli	It doesn't matter
Það tekur því ekki	That's not worth the time
Þægilegur	Comfortable
Þætti	TV show
Þágufall	Third case
Þak	Roof
Þak	Roof
Þakklátur	Thankful
Þannig	That's how / that kind
Þannig er _____ / svona er _____	That's how _____ is (2)
Þar	Where (non-question)
Þarna / þangað	There (stationary/moving)
Þarna skall hurð nærn hælum	That was close
Þátíð	Past
Þátíð	Past tense
Þátttakandi	Participant
Þegiðu	Shut up
Þeirra	Their
Þjálfari	Coach
Þjónusta	Services
Þoka	Fog
Þólfall	Second case
Þorp	Village
Þota	Jet
Þota	Jet
Þráður	Thread
Þrátt fyrir	Despite
Þríhyrningur	Triangle
Þrír / þrjár / þrjú	Three (3)
Þrjóskur	Stubborn
Þrjóskur	Stubborn
Þrjóskur	Stubborn
Þröngur	Narrow
Þröngur / mjór	Narrow (2)
Þröngur / mjór	Narrow / thin (2)
Þrumur	Thunder
Þrýstingur	Pressure
Þú / þig / þér	You (3 cases)
Þú mátt ganga út frá því sem vísu	You can count on it
Þungur	Heavy
Þunnt	Thin
Því líkur	What a...
Því miður	Unfortunately
Þvottur	Laundry
Þykkt	Thick
Þyngri	Heavier
Þyrla	Helicopter
Þystur	Thirsty 
