100 đô la	$100
10 đô la/ 1 giường	$10 dollars for one bed
10 ngày	10 days
11 giờ đêm	11 p.m. (đêm = night)
11 giờ tối	11 p.m.
1,2	1.2
12 dộ C	12 degrees C
12 giờ đêm	12 midnight
12 giờ đêm	12 midnight
12 giờ trưa	12 noon
12 giờ trưa	12 noon
16 ngày	16 days
1 ngày 1 lần	1 time per day
1 ngày 3 lần	3 times per day
1 vali sữa bột	One suitcase of powdered milk
22 độ C	22 degrees C.
25 độ F	25 degrees F
2 chiều	2 p.m.
2 con chó ở 2 nhà	2 dogs in 2 houses
2 triệu	Two million đồng (around $100)
30 sinh vien	30 students
3 tháng rồi	3 months
3 thuyền	3 boats
500 đồng	500 Vietnam đồng
6 giờ chiều	6 p.m.
6 người	6 people
6 tiếng?	6 hours?
ai làm bánh kếp?	who makes the pancakes?
Ai nấu ăn cho bố mẹ anh?	Who cooks for your parents?
ai	who
ai	who?
âm lịch	Lunar, lunar calendar
âm lịch	the lunar calendar
ẩm ướt	moist
ấm	warm
ăn chè	Eat sweet soup
ăn cơm	Eat a meal (eat rice)
ăn	Eat
Anh ăn sáng rồi	I ate breakfast already
Anh ăn táo	I ate an apple
anh ấy gọi Phở	You order pho?
Anh ấy hát cho nhà thờ	He sings at church
anh bận phải không?	You are busy, no?
anh	Brother (...), older brother. Polite term used to address a male friend; (my) older brother or same age
Anh buồn một chút?	Are you a little sad?
Anh/chị có cái khác không?	Do you have any others?
Anh/chị có dùng thẻ tín dụng không?	Do you pay by credit card?
Anh/chị có nhận thẻ tín dụng không?	Do you accept credit cards?
Anh/chị có size lớn hơn/ nhỏ hơn không?	Do you have the bigger/ smaller size?
Anh/ chị có thể viết giá được không?	Can you write down the price?
anh chỉ mặc áo sơ mi thôi, không mặc áo ấm	I'm (or I was) only wearing a shirt, not a sweater.
Anh chờ em 5 phút nhe!	Please wait for me for 5 minutes!
anh chồng	husband
Anh chưa ăn gì.	I didn't eat anything yet
anh có ăn mừng không?	Did you celebrate?
Anh có biết phố Tràng Tiền ở đâu không?	Do you know where Tràng Tiền is?
Anh có biết thầy Q ở trường X không?	Do you know Professor Q at X?
Anh có biết thầy Z ở trường Yale không?	Do you know Professor Z at Yale?
Anh có câu hỏi nào không?	Do you have any questions?
Anh có câu hỏi nào không?	Do you have a question?
anh có chụp hình nhiều không?	Do you take a lot of photographs?
Anh (có) học kinh tế Việt Nam không?	Are you studying Vietnamese economics?
anh có khát không?	Are you thirsty
anh có khát không?	Are you thirsty
anh có khát không?	Are you thirsty
Anh có nhận thẻ tín dụng không?	Do you accept credit cards
anh còn học bao lâu nữa?	You also study how much longer?
Anh có thể lái chậm lại được không?	Could you slow down?
Anh có thể thấy Vịnh hạ Long từ nhà Xuan.	One can see Ha Long Bay from Xuan's house
anh cũng vậy	Me too!
Anh (đã) đi đâu?	Where (did) you go
Anh đã đi Vịnh Hạ Long bao giờ chưa?	Have you been to Ha Long Bay?
Anh đã học tiếng Việt ở Mỹ (được) bao lâu?	How long did you study Vietnamese language in America?
Anh (đang) học gì đó?	What are you studying?
Anh (đang) làm gì đó?	What are you doing?
Anh (đang) nói chuyện với ai?	With whom are you talking?
Anh đang ở đâu?	Where are you?
Anh đã tự học tiếng Nhật được 5 năm.	I taught myself Japanese for 5 years
Anh đến lớp sớm hơn giáo viên hay muộn hơn giáo viên?	You go to class earlier or later than the teacher?
Anh đến thư viện hồi mấy giờ? (here hồi means time)	At what time will you return from the library
Anh đến thư viện hồi mấy giờ?	When will you return from the library?
Anh đến (từ) bao giờ?	(Since) when did you come?(No.)
Anh đến (từ) hồi nào?	(Since) when did you come?(So.)
Anh đẹp trai không?	Are you handsome?
Anh đẹp trai không?	Are you handsome?
Anh đẹp trai không?	Are you handsome?
anh đi ăn ở ngoài	I went out to eat
anh đi ăn tiệm	I went out to eat
Anh đi chơi vui nhe!	Go have fun, right?
Anh đi đâu đấy?	Where are you going? (In other contexts, dấy means there, but at the end of the word, it refers to an action in progress. You can omit it, but it is similar to our "now." The same is true of đó)
anh định đi sông Estero chỗ có nước mặn	I intend to go to a part of the Estero River where there is salt water
anh đính hôn với Hang	You got engaged with Hang
Anh đi Việt Nam bón lần rồi	You went to Vietnam five times already
anh đi Vn mấy lần rồi?	How many times have you gone to Viet Nam
anh đi với 6 bạn	I'm going with 6 buddies / companions / people
Anh đọc theo em nhé!	repeat after me
Anh đỡ hơn.	You are better
Anh đói (bụng) không?	Are you hungry?
anh đón Y	I pick up Y (by car)
Anh	England
anh giỏi hơn	You are more skilled
Anh học gì đó?	What are you studying?
Anh học vật lý được bao lâu rồi?	How long have you been studying physics?
anh học xong lúc 6 giờ	You finish studying at 6 p.m.
Anh hỏi đi!	You ask the questions
Anh hỏi	You ask
Anh khỏe không?	Are you well?
Anh khỏe không?	How are yoiu?
Anh khỏe không?	How are you
Anh khỏe không?	How are you?
Anh không đi đâu.	I didn't go anywhere
anh không học tiếng Việt được?	You can't study Vietnamese
Anh _____ không nấu ăn được	You don't cook
Anh làm bánh kếp cũng ngon.	You can also make tasty pancakes
Anh làm bánh kếp được./ Anh biết làm bánh kếp.	I can make pancakes
Anh làm gì đấy?	What are you doing? (here đấy refers to an action in process, not to "there")
Anh làm gì đó?	What are you doing? (here đó refers to an action in process, not to "there")
Anh làm việc từ mấy giờ đến mấy giờ?	From what hour until what hour do you work?
Anh là người nước nào?	Where are you from?
Anh lập gia đình bao lâu rồi?/ lâu chưa?	How long have you been married?
Anh lập gia đình được bao lâu rồi?	How long ago did you get married?
anh muốn đi cắm trại	I want to go camping
Anh nấu được.	I can cook
anh nghe em rõ không?	Can you hear me clearly?
Anh nghe em rõ (lắm).	I hear you clearly (well)
Anh nghĩ đi thuyền mất 2 tiếng đến đó.	I think the boat trip takes 2 hours to get there
anh nói lại đi!	Say it again
Anh nói tiếng Anh dễ lắm.	You speak English easily
Anh nói tiếng Anh giỏi hơn em ấy	I speak English better than her
Anh nói tiếng Nhật cũng tạm được.	I also spoke Japanese for a while
Anh ở đó bao lâu?	How long have you lived there?
anh ở đó rồi?	You have been there?
Anh	older brother, for a slightly older man, or for the man in a romantic relationship. (S)
Anh ở nhà xem bóng đá	I stayed home watching soccer
Anh ở số mấy phố Clinton?	What number are you at on Clinton Street?
Anh ở / từ Pháp đến Mỹ từ bao giờ	When did you come (arrive) from France to the U.S.
Anh ở Việt Nam bao lâu?	How long will you be in Vietnam?
Anh ở Việt Nam từ ngày 14 tháng 12 đến ngày 24 (tháng 12).	I'll be in Vietnam from December 14 until December 24.
Anh ở vùng nào ở Los Angeles?	Which suburb in Los Angeles do you live in?
anh phải đi kiểm tra sức khỏe định kỳ	I have to go for a routine health checkup
Anh phải đợi	I have to wait
Anh phải đợi	I have to wait
Anh phải đợi	I have to wait
anh quên hết rồi	I already forgot
Anh Quoc đón vợ không?	Will Quoc pick up his wife? (by car)
Anh sẽ đi bao lâu?	For how long will you go?
anh sẽ đi câu cá	I will go fishing
Anh sẽ đi Sài Gòn không?	Will you go to Saigon?
Anh sẽ đi Vn/ Hà Nội	You will go to Vietnam / Hanoi
Anh sẽ ở Việt Nam bao lâu?	How long will you be in Vietnam?
Anh sẽ ở Việt Nam mười ngày	You will be in Vietnam for 10 days
anh sinh ngày mấy?	What day were you born
Anh thấy đỡ hơn.	You are feeling better
Anh thấy Ha nói tiếng Anh giỏi nhưng Ha thấy không tự tin.	I feel that Ha speaks English well, but Ha does not feel confident
Anh thấy Phở thế nào?	How do you feel about Phở (do you like it)?
Anh thấy rau đó có ngon không?	Do you feel that vegetable tastes good?
Anh thấy thế nào?	how do feel?
Anh thích đội nào?	You like which team?
anh thích nghe ông ấy giảng	I like to hear him teach / speak / preach
Anh thích uống cà phê nóng hay lạnh?	You like to drink coffee hot or cold?
Anh thức dậy chưa?	You didn't wake up yet?
anh thử đi	I'll try to go
anh thường uống cà phê đen	I usually drink black coffee
Anh trả lời	You answer
anh tự học ở nhà	I study by myself at home
anh uống cà phê một ngày mấy lần?	You drink coffee how many times per day?
anh vẫn	He still
Anh và Y có hạnh phúc không?	Are you and Y happy?
Anh về Mỹ hồi nào vậy? "vậy" particle	when did you return to the U.S.,huh?
Anh về nhà lúc mấy giờ?	what time do you come home?
anh về rồi	I'm home (I return already)
ăn mừng	to celebrate
ăn sáng	breakfast
ăn sáng chưa?	Did you have breakfast yet?
ăn thử	Tasting ("test eat)")
ăn tối ở nhà	Dinner at home
ăn trưa	Eat lunch
ăn với gì?	eat with what?
À...	Oh...
ấy	that
Bác	parent's older sister, used to address a woman slightly older than one's parents or wife of father's older brother or wife of mother's older brother.
bác sĩ	doctor
bác sĩ	doctor
ba của anh	Your father
ba	father
Ba giờ rồi.	(It's) 3:00.
Bà	grandmother, used as a term of respect for a (usually married) woman senior to the speaker and who is late middle age or older
bài	Classifier used for compositions like songs, drawings, poems, essays, etc.
Bài hát	song
bài học	lesson
bài kiểm tra	test
bài tập 3	Exercise 3
Bài tập	Exercises
bài	Written work, lesson, text
ba mẹ anh	My parents
ba mẹ; ba má	Parents (literally: father mother), in the South
bà	Mrs., you, your; Madam (literally, 'my grandmother')
ba mươi lăm	thirty five
ba mươi mốt	thirty one
ba mươi	thirty
bận	Busy / engaged
bạn của bạn	A friend of a friend
bạn của bạn em	A friend of my friend
bạn em	my friend
bạn	friend
bằng	by
bằng chương trình Pimsleur	By the Pimsleur program
Băng Cốc	Bangkok
bằng nhau	equal
bằng nhau	equal
bằng xe hơi / bằng xe ô tô	By car
bạn Hanh's nhớ em ấy mua nhiều thứ đem về VN	Hanh's friends are asking her to buy a lot of things to bring to Viet Nam
Bánh kếp Hungary cũng mỏnh như bánh kếp Pháp.	Hungarian pancakes are thin like French pancakes
bánh kếp	pancake
ban ngày 29 độ C	Daytime 29 degrees C
bận rộn	busy
bán thời gian	Part-time (half-time)
Bao giờ anh đến?	When will you come?
Bao giờ anh về lại Mỹ?	When will you go back to the U.S.
Bao giờ chị từ/ở Luân Đôn về?	When will you return from London
Bao giờ chị từ/ở Luân Đôn về?	When will you return from London
bao giờ chưa?	before
bao giờ chưa?	ever before
bao giờ chưa?	Ever before? [ as in have you every been there / done this before]
bao giờ = khi nào	when
bao giờ / mấy giờ...về?	When/What time will you return?
bao giờ	when
bao nhiêu tiếng?	How many hours
Bao nhiêu tiền?	How much is it?
Bao nhiêu tiền?	How much is it?
Bao nhiêu tiền một kí?	How much does a kilo cost?
bao nhiêu tiền vậy em?	So how much money?
bao nhiêu tuổi?	How old are they? (literally, how many age?)
Bá	parent's older brother or sister, used to address a man/woman slightly older than one's parents or husband of father's older sister or husband of mother's older sister.
bắt đầu	start
ba	three
Bây giờ anh đang làm gì? Tôi đang học tiếng Việt.	What are you doing now? I'm studying Vietnamese.
Bây giờ anh không có (theo) đạo gì	Now I don't have a religion (religion = follow path)
Bây giờ anh làm gì? Tôi làm luật sư.	What do you do for a living now? I work as a lawyer.
Bây giờ anh ở đâu?	Where are you now?
Bây giờ bà đi bưu điện, phải không?	Now you are going to the post office, right? (Vâng, tôi đi đến đó.) Yes, I'm going there.
Bây giờ chị của Lan đang sống ở Hà Nội	Now Lan's sister is living in Ha Noi
Bây giờ chị làm nghề gì?	What kind of work do you do now?
bây giờ là 22 độ C	Now it's 22 degrees C
Bây giờ là 9:30	Now it's 9:30, no?
Bây giờ (là) mấy giờ rồi?	What time is it now?
bây giờ	now
bây giờ tốt hơn nhiều	much better now
bảy mươi lăm ngàn	75,000
bảy	seven
bảy trăm năm mươi ngàn	750,000
bệnh viện = bịnh viện	Hospital
bia	beer
Bia	Beer
Bia tươi/ bia hơi	Draught beer
bị đau	Hurt (suffer pain; suffered an injury)
biển	sea
bình	bottle
bình thường	Normal / ordinary / regular
bị ốm	Suffer from an illness; be sick
bị	Suffer (any misfortune)
Bố/Ba/Cha	father
bố/ ba	father
bố/ ba	father
bờ biển	Coast (sea's edge); seashore; seaside
bò	cow
Bộ Di trú	Ministry of Immigration
bờ	edge
Bộ Giáo Dục	Department of Education
Bộ Giáo dục	Ministry of Education
Bố mẹ anh có trẻ không?	Are your parents young?
Bố mẹ anh có trẻ không?	Are your parents young?
Bố mẹ anh có trẻ không?	Are your parents young?
Bố mẹ anh khỏe nhưng ông bà tám mươi bốn tuổi rồi	My parents are healthy, but they are eighty four years old already
bố mẹ anh vẫn lái xe được?	Can your parents still drive a car?
bố mẹ của anh là người công giáo/ theo đạo công giáo	My parents are Catholic / follow the way of the Catholic religion
Bố mẹ	Parents (literally: father mother), in the North
Bộ	Ministry
bốn	four
bóng đá	soccer
Bốn giờ tôi đi.	I'm going at 4:00.
bộ ngoại giao	government ministry foreign affairs (in U.S.A.: State Dept.)
bốn mươi	forty
bốn mươi lăm	forty five
bốn mươi mốt	forty one
Bộ Nội vụ	Ministry of Interior
Bộ Nội vụ	Ministry of Interior
bốn trăm linh/lẻ bảy	407
Bộ Tài chính	Ministry of Finance
bớ tay	My hands are tied (there is nothing I can do); literally, to tie hand
bò / thịt bò is beef specifically but bò is also used	Cow or beef
bố tôi không thể xoay cổ được.	My father can't turn his neck well
Bộ Xã hội	Ministry of Social Welfare
Bún Bò Huế	A soup containing thin rice noodles and beef, along with lemon grass, that originated in Huế
Bún Chả Giò	Vietnamese spring rolls with a bed of lettuce, herbs and bún (rice noodles)
Bún Nem Nướng	Cold bún noodles topped with grilled pork meatballs
Bún	Rice noodles that are as thin as vermicelli
Bún Riêu Cua	Vienamese sour crab noodle soop; pork bones; tomatoes; crab paste; dried shrimp
Bún	Round rice noodle soup
bưởi; bưởi vàng; bưởi xanh	Grapefruit; pomelo; yellow pomelo; green pomelo
buổi nào anh thích hơn?	Which part of the day do you prefer
Bưởi	Pomelo
buổi sáng	morning
buổi sáng	morning
buổi tối	Night time
buổi tối ở Mỹ	night in America
buồn cười	funny
buồn	sad
buồn >< vui	sad >< happy
buồn >< vui	sad >< happy
buồn >< vui	sad >< happy
bưu điện	Post office
Các anh học gì dấy	You men are studying what?
Các anh	You men
các chị ấy đi đâu? Họ đi xem phim.	What are those ladies doing? They are going to see a film.
các chị đi đâu (đấy)? Chúng tôi đi sân bay.	What are you ladies doing? We are going to the airport
Các chị làm gì đấy	You ladies are doing what?
Các chị	You ladies
cách đây 1 năm	1 year ago
cách đây 3,4 năm rồi	3 or 4 years ago
cách đây	ago
cách đây	ago
cách đây (precedes the time, e.g. hai tuần cách đây)	ago
cá	fish
Cá	Fish
cả hai	both
cả hai	both
cái	A counting / categorizing word for inanimate nouns; translation usually just "the." Also used as a co-classifier for both inanimate and animate subjects, where there is some other classifier (such as con for an animal) and the use is to focus emphasis on this particular subject as distinct from others. Translation in that use might be "this very _____."
cái bàn	A desk
cái cốc	A glass (for drinking)
cái cửa	A door
Cái này bao nhiêu tiền?	How much is this?
Cái này tiếng Việt gọi là gì?	How do you call this in Vietnamese?
Cải Thìa	Bok choy
Ca-li	California
Cám ơn anh nhiều lắm!	Thank you very much
Cám ơn anh nhiều lắm!	Thank you very much.
cám ơn	thank (you)
Cảm ơn	Thank you
Cẩm Phả (gần Vịnh Hạ Long)	Cẩm Phả (town near Hạ Long Bay)
Cam - pu chia; Campuchia	Cambodia
Canh	Soup
cà phê	coffee
cà-phê	coffee
Cà phê đá	Ice black coffee
cà phê đá	Iced coffee
cà phê đá	Iced coffee (coffee on the rocks)
Cà phê đen	Black coffee
cà phê nóng	hot coffee
cà phê nóng	Hot coffee
Cà phê sữa đá	Ice white coffee
câu cá	fishing
câu	Classifier sentential constructs (verses, lyrics, statements, quotes, etc.)
câu lạc bộ	Club (not for a bar or night club but for a group of people who gather to do something, or a tennis club - which may combine a place with a group of people doing something).
câu lạc bộ Hoàn Kiếm	Hoàn Kiếm Club
câu lạc bộ	Social club
Câu mẫu	Patterns
Cậu	mother's brother, used to address a younger man or a man as old as one's mother
câu	question
cây có nhiều màu	the trees have many colors
cây năng lượng	Gardens by the Bay, a park in Singapore near its bay. It has supertrees, tree-like structures filled with photovotaic cells and gardens. A literal translation is tree energy
chắc là không	Probably not
chắc là không	Probably not
chắc là không	Probably not
Chậm lại	slow
Chậm lại...	Slow down
chấm	Point (dot) as in sáu chấm một = 6.1
Chào anh Carl. Hôm nay anh có khỏe không?	Hello, Carl. How are you today?
Chào anh	Hello (to man)
Chào anh X	Hello X
chào bà	Hello (older woman)
Chào bà	I greet you (Mrs.)
chào cô	Hello (adult woman; female teacher)
chào cô	Hello (female teacher; grown woman)
Chào cô ______	Hello (teacher / Ms.) _____
chào ông	Hello (older man)
chào	to greet
Chào _____. Tôi khỏe. Con em? Em khỏe không?	Hello ___ . I'm we'll. How about you? How are you?
Cháu	nephew/niece, grandson/granddaughter; used to address a young person of around such relative age
cháu trai	nephew
chè đậu xanh	Sweet soup with green beans
chè hạt sen	Lotus seed sweet soup
chè (no.), trà (so.)	tea
chèo	paddle
chèo thuyền	paddle boat (Kayak)
chè	sweet soup
chè = trà	tea
chỉ 100 đô la Mỹ thôi (both chỉ and thôi mean only in this sentence)	Only $100
chỉ có một cốc	Only one cup
Chị cũng ở Los Angeles, thế địa chỉ chị là gì?	She also lives in Los Angeles, so what is her address?
chiếc	Classifier almost similar to cái, usually more connotative (e.g. when referring to a cute object, it might be more suitable than cái)
chiều	afternoon
chiều	afternoon
chiều	later afternoon
chiều mai	Tomorrow afternoon
chiều	pm (afternoon)
chiều	pm or afternoon
chiều	từ 3:00pm đến 6:00pm
chị Lanh có chồng rồi/ có gia đình ở Huế	Her sister Lanh has a husband already; has a family in Huế
chín giờ sáng	9 a.m.
Chín giờ sáng mai tôi sẽ đi.	I'll return at 9 o'clock tomorrow morning
chín	nine
chín trăm lẻ năm ngàn	905,000
Chị	older sister, for a slightly older woman. (S)
Chị sẽ đi	You / I (female) will go
chị	Sister (...), older sister. Polite term used to address a female friend; (my) older sister or same age
chị Thanh	You can't say just the person's name; you have to say the pronoun (em, chị, anh) if that person is with you , e.g. for Thanh, an adult woman not much older than you
chỉ thứ 3 và thứ 5 thôi?	Only Tuesday and Thursday
chỉ	To point out; to show
chị Trang	Sister Trang
chị vợ / em vợ	Sister in law (older sister / younger sister)
cho anh một ly nước chanh nữa	Bring me another glass of lemonade
cho anh một tô Phở gà	Bring me a bowl of chicken pho
cho anh thêm một chai nữa (here both thêm and nữa mean more)	Bring me one more bottle of beer
cho anh tính tiền	Bring me the bill / check
chờ anh / tôi 10 phút nhe! The nhe softens it	Wait 10 minutes for me
chờ anh / tôi 10 phút nhe! The nhe softens it	Wait 10 minutes for me
chờ anh / tôi 10 phút nhe! The nhe softens it	Wait 10 minutes for me
chó	dog
cho em gởi anh 1 link nữa nhe	Let me send you another link, huh?
cho	give
chơi	play
chơi	to enjoy leisure time
chỗ khác	elsewhere
cho khỏ.	For health
chợ	market
Chôm chôm	Rambutan - these look a little like lychee but are different; first they have "hair" on the outside; the inside is also different.
cho tôi	For me (as in make coffee for me)
cho tôi hỏi	May I ask you a question?
Cho tôi một chai bia	Give me one bottle of beer
Cho xem thực đơn	Give me menu
Chưa. Anh chưa đi bao giờ.	I have never been there yet.
chưa biết	Don't know yet
chưa đến/ chưa tới 3 phút	Less than 3 minutes
chưa đúng	Not yet correct
chú anh không nhớ tốt	My uncle does not remember well
chưa	Not yet
chưa tốt lắm	not right yet
Chúc anh chị một ngày thật vui!	May you and she have a nice day
Chúc anh một ngày thật vui!	Have a nice day (Wish you one day fun)
Chúc anh một ngày thật vui nhe!	May you have a very happy day!
Chúc cô ngủ ngon!	I wish you good night; or sleep well
Chúc em ngủ ngon!	I wish you good night; or sleep well
Chúc ngon miệng	Enjoy your meal!
chúc ngủ ngon	Goodnight / sleep well
Chú	father's younger brother, used to address a man slightly younger than one's father or husband of father's younger sister.
chúng con	We (children to parent)
chúng con	We (group of children speaking to parent)
Chúng ta có thể học lúc 9 giờ 30 được không anh?	We can study at 9:30, OK?
Chúng ta dừng/ ngừng ở đây nhe! (You can say this to a taxi driver)	We stop here, huh?
Chúng ta dừng/ ngừng ở đây nhe! (You can say this to a taxi driver)	We stop here, huh?
Chúng ta dừng/ ngừng ở đây nhe! (You can say this to a taxi driver)	We stop here, huh?
chúng ta dừng ở đây nhe!	we'll stop here, ok?
chúng ta	we( including listener)
chúng tôi ăn ở hiệu ăn/ chúng tôi ăn ở ngoài	we eat at restaurants / we eat out
chúng tôi / chúng em	We / us
chúng tôi / chúng ta	we
Chúng tôi học bài Hai	We are studying lesson two
chúng tôi sẽ tổ chức đám cưới ở Vn	We will have a wedding ceremony in Vietnam
Chúng tôi thường ăn thức ăn / món ăn Việt.	We usually eat Vietnamese food
Chúng tôi vào bưu điện	We are going to the post office
Chúng tôi vào câu lạc bộ	We are going to a social club
Chúng tôi vừa mới mua căn hộ để bố (của) Lien sống ở đó	We just (recently) bought a condo for Lien's father to live there
Chúng tôi	We
Chủ Nhật	Sunday
Chuối	Banana
chương trình	program
chút	little
chuyện	Classifier a general topic, matter, or business
Cô ấy làm bài Bốn	That lady is doing lesson four
Cô ấy làm bài Hai	That lady is doing lesson two
Cô ấy	That lady
cốc bia = ly bia	Glass of beer
Có chứ	of course
Có chứ	Of course
cốc = ly	cup
có dễ không?	Is it easy?
Cô	father's sister, used to address a younger woman or a woman as old as one's father; also used to address a female teacher regardless of relative age
có gần không?	Is it near?
Có giảm giá không?	Can you lower the price?
Có giảm giá không em?	Can you reduce (the price)? (for bargaining)
Có giảm giá không vậy em?	Can you reduce (the price)? (for bargaining)
Cô giáo bắt đầu giảng bài( đó) rồi.	The teacher began to lecture already
cô giáo	female teacher
Có. hôm qua anh có đi học.	Yes. Yesterday I went to school.
có lẽ chỉ ở Mỹ thôi?	maytbe only in the U.S.?
có lẽ	maybe
có lẽ vậy	Maybe so
cô	Miss (...), Miss, aunt; Miss (literally, 'my aunt'); female teacher
Cơm	Rice
cơm	Rice or food
cơm Tàu	Chinese food
còn	Also, still, yet
còn	and as for, and how about
còn	As for . . . (a person); how about?
con beo	panther
Con chào bố (ạ).	Good morning father
Con chào bố (ạ).	Hello father
Con chào bố.	Good morning father
Con chào bố.	Hello father
Con	child; also used in some regions to address a person as old as one's child
con chó đó có phải là thú nuôi không/ cưng không?	Is that dog a pet?
con chó	dog
con	Classifier usually for animals and children, but can be used to describe some non-living objects that are associated with motion
cổ	neck
còn em thì sao?	How about her?
(con) gấu to	Big bear
công chức	Public servant (southern dialect). viên chức/ công chức public servant, official, civil servant
Công Giáo	Catholic
công viên	Park (meaning an outdoor public space with vegetation, not parking a car)
Có nhiều chỗ đẹp để chèo thuyền.	There are many beautiful places to paddle
có nhiều đá ngầm	There are a lot of reefs
còn học nữa không?	Do you still study?
Còn kia là ai?	And who is that over there
Con mời bố dùng cơm/ ăn cơm.	Child to father - I invite you to eat
Con mời bố uống chè.	Child to father - I invite you to drink tea
còn Phuong thì sao? (here thì sao does not mean why, but what about?)	And Phuong, how about her?
Còn tôi	And I, as to me
cỡ	size
có thể xem miễn phí	Can watch for free
có thức khuya không?	Did you stay up late?
Có, tôi thường bận (vào) cuối tuần. / Tôi thường làm việc cuối tuần.	Yes, I'm often busy on weekends / I often work on weekends
có xa không?	Is it far?
Có xa không?	Is it far?
của anh là gì/ số mấy?	Your _______ is what? What number? [as in address]
(của) chúng tôi	our
của	of / belong to
cũng	also (considered a verb in Vietnamese)
cũng được	It's also ok
cũng giờ này	Also at this time
cũng giờ này?	Also at this time; at the same time (as we did today)
cũng giờ này	At the same time (also this time)
cũng giờ này	At the same time (this time also)
cũng giờ này	Same time
cũng giờ này	Same time
cũng thường thôi	Nothing special; same as usual
cũng vui	also fun
cuối	end, the end
cười	laugh
cuối năm	End of the year
cuối năm nay	At the end of this year
cuối năm nay	The end of this year
cuối ngày	End of the day
cuối tháng	End of the month
cuối tháng sau	End of next month
Cuối tuần anh có thường bận không?	On the weekends are you usually busy?
Cuối tuần này anh bố mẹ có đi thăm không?	This weekend will you visit your parents?
Cuối tuần này anh bố mẹ có đi thăm không?	This weekend will you visit your parents?
Cuối tuần này anh bố mẹ có đi thăm không?	This weekend will you visit your parents?
cuối tuần này anh định đi đâu ?	This weekend where do you plan to go?
cuối tuần	weekend
cuối tuần	weekend
cuối tuần	weekend
cuối tuần	weekend
cuối tuần	weekend
Cuối tuần	weekend
cuốn sách	A book
Cứu tôi với!!!	Help!
đã	Already, or [make a verb past tense, like "have" plus participle in English]
Dạ, cám ơn anh Nam, tôi khỏe lắm. Còn anh, thế nào?	I am fine, thank you, Nam. And you, how goes it?
Dạ, cám ơn, tôi cũng khỏe. Anh ở Việt Nam (được) bao lâu rồi?	I'm well too, thanks. How long have you been in Vietnam?
đặc	Compact / concrete / special / (verb) deposit
da đen	Black (skin)
Dạ được chứ.	Yes, of course.
Dạ em khỏe, cám ơn anh.	Yeah, I'm fine, thanks
đá	ice
đá	Ice (or stone), term used to mean iced coffee when used with cà phê
đại học	university
(Dạ) không, cám ơn	No, Thanks
Dạ không có gì/ không có chi.	You're welcome.
Dạ, không có gì	Yes, don't mention it
dạ không	No
Dạ. Không sao đâu. Anh nghỉ ngơi cho khỏe nhe.	Yes. No problem. You take a rest to feel better.
đã mời em ở nhà của chị ấy	I was invited to her house
Dã	nature
đang	Connotes current action
đang	Used before a verb to indicate an action in process, e.g. you are working = anh đang làm viẹc
đàn ông	man
dạ phải/ vâng.	yes
Dạ	Polite response particle
đá	Rock / ice
Dạ rồi	Yes, already (yes I did go there already)
đắt	expensive
(Dạ) tôi ở đây (được) sáu tháng rồi.	I've been here for six months.
đắt quá	Too expensive
da trắng	White (skin)
đậu	beans
đầu	beginning
đau đầu	headache
đậu đỏ	Red beans
đầu	Head or top or first
đau = ốm	Pain / sick
đau = ốm	Pain / sick
đau = ốm	Pain / sick
đau	pain
đau	pain
đầu tháng tới	early next month
đâu	where
đâu	Where?
Dạ/ vâng/ có/ đúng	Yes
Dạ vâng/ Vâng/ Dạ Phải/ Phải.	Right or yes
đấy / đó	This; here
đấy / đó/ vậy/ thế?	Can add any of these; Doesn't change the meaning
Dạ	yes
Dạ	yes
Dạ	yes
đây	here
dạy kèm	Tutoring
dạy lịch sử VN	Teach Vietnamese history
dạy	to teach
dễ cho em/ dễ với em	Easy for you
dễ cho em/ dễ với em	Easy for you
dễ cho em/ dễ với em	Easy for you
dễ	easy
dễ	easy
dễ	easy
để làm gì?	To do what?
đem	bring
đêm	night
đêm	night
đêm	night
đêm	Night
đêm	Night [12 giờ đêm = midnight; 1 giờ sáng = 1 a.m. (one in the morning) and 1 giờ đêm = 1 in the morning (one at night)]
đem	To bring; to carry
đêm	từ 10:00p.m đến 1:00p.m
đến..chơi	come to visit
đến thăm tôi	Visit me
đến	to
đến	to come to, arrive at
đến	To or arrive
Đẹp hơn anh	Prettier than me
đẹp và yên tĩnh	Pretty and quiet
đẹp>< xấu	beautiful>< ugly
đẹp>< xấu	beautiful>< ugly
đẹp>< xấu	beautiful>< ugly
dễ tính	easygoing
dễ tính	easygoing
dễ tính	easygoing
để	To (in order to)
để	To / so that / for
địa chỉ	address
địa chỉ	address
địa chỉ của anh số 1`23 phố ....	Your address is number 123 ______ street
đi ăn ở ngoài	go out to eat
đi ăn tối, (và) uống cà phê thôi	go out for dinner and then drink coffee
Đi bộ mất bao nhiêu phút?	How many minutes does it take to walk?
đi câu cá	Go fishing
đi chợ/ đi siêu thị	Go to the market / go to the supermarket
đi chợ/ đi siêu thị	Go to the market / go to the supermarket
đi chợ/ đi siêu thị	Go to the market / go to the supermarket
đi chơi	go out (including go out to play)
đi chơi	Go play; go out
đi chơi vui nhe!	Go out and have some fun!
đi đám cưới	go to a wedding
đi đâu?	Going where?
đi đến	There are some place words with which đi 'to go' is not used by itself. These place words are more comfortable with đến 'to arrive at' or with đi đến. Tôi đi đến trường I'm going to the school. Tôi (đi) đến (nhà) chị Mai. I'm going to Mai's (place/ house).
đi đường bình an	Have a prosperous trip; have a safe trip; bon voyage
đi làm có xa không?	Goes to work far away?
đi làm	Go to work; commute
Đi mất 15 phút	To go takes 15 minutes
Đi mất bao nhiêu phút?	To go there takes how many minutes?
Dì	mother's sister, used to address a younger woman or a woman as old as one's mother; also used to address one's stepmother
đi Mỹ lại	go to U.S. again
đi ngủ	Go to sleep
đi ngủ khoảng 12 giờ khuya (khuya means late at night)	Go to bed around 12 p.m.
đi ngủ lúc nửa đêm	Go to sleep at midnight
định kỳ	Regular or periodic
đi nước ngoài	go to a foreign country
đi thăm giáo sư (của) chúng tôi	Visit our professor
đi thăm	visit
đi thăm	visit
đi thăm	visit
đi thăm	visit
đi	to go
(đi) vào	enter
đi xa	go far
đi xem phim	Go to the movies
đọc	to read
đó / đấy	there
độ	Degree (temperature)
độ F	Degrees F.
đội bóng đá của	soccer (football) team
đói bụng ?	hungry?
đợi/ chờ	to wait
đợi/ chờ	to wait
đợi/ chờ	to wait
Đôi khi/ thỉnh thoảng gia đình chị của Mai cũng sống ở đó	Sometimes / occasionally, Mai's sister's family also lives there
đôi khi vợ tôi nấu (ăn) cho bố mẹ anh.	Sometimes my wife cooks for my parents
Đôi khi Y làm việc ở nhà.	Sometimes Y works at home
đội LA sẽ đá với đội..	Team Los Angeles will play (kick) with team . . .
Đợi ở đây.	Wait here
đội	team
Đối thoại A1a	Dialog A1a
đô la	dollars
Đó là năm 2010	That was in 2010
Đó là năm nào?	What year
đông	crowded
đồng hồ reo/ báo thức	alarm clock / alarm
Đông Nam	South east (East South)
đông và ồn ào	Crowded and noisy
đón	Pick up (also means welcome)
đỏ	red
Do Thái	Jewish
đó	there
Dưa hấu	Water melon
Dứa/ Thơm	Pineapple
Đu đủ	Papaya
du lịch	travel
du lịch	travel
du lịch	travel
Dừng lại ở đây	Stop here
Dừng lại ở đây.	Stop here
dừng / ngừng	stop
dừng/ ngừng	stop
dừng/ ngừng	stop
dừng/ ngừng	stop
dừng ở đây	Stop here
dừng	Stop
dụng	use
Đúng	Yes
được>< bị	Used for good things that occur; used for bad things, suffering
được một ít.	Got it a little
được	to be able to do something
Dượng	husband of father's older sister; also used to address one's stepfather
dương lịch	the solar (Western) calender
dương lịch	Western calendar
đường (southern dialect)	street
đường	sugar
E cám ơn a!	Thank you (shorthand used in text message, written by younger person to older)
Em ấy làm việc từ 10 giờ trưa đến 6 giờ chiều.	She works from 10 (midday) until 6 in the evening
Em ấy nói tiếng Anh tốt hơn tôi nói tiếng Việt	You speak English better than I speak Vietnamese
em ấy nói tiếng Việt giỏi hơn/ tốt hơn anh	She speaks Vietnamese better than me
em cho anh một tô phở	Bring me a bowl of pho
em cho tôi hỏi	May I ask you a question?
em chưa xem	I have not seen it
em có bớt không?	Can you reduce (the price)? (for bargaining)
em có gia đình chưa?	Do you have a family yet (are you married)?
em có giảm giá không?	Can you reduce (the price)? (for bargaining)
Em có thể gặp thứ bảy (được) không?	Can you meet Saturday?
Em cũng vậy	Me too
Em cũng vậy	Me too (I'm also well)
Em cũng xin lỗi anh, em trễ	I also apologize to you; I was late
Em đã đi Hội An bao giờ chưa?	Have you ever gone to Hoi An?
em đã ngủ trên thuyền 1 đêm	I slept on the boat one night
em đã ở nhà của một sinh viên của em	I was at the home of my student
em đã xem cây Thích ở Vermont	I have seen Maple trees in Vermont
em đi 1 lần cách đây 4 năm rồi [cách đây 4 năm is ago 4 years]	I already went there 4 years ago
em đi 2 lần rồi	I went there twice
Em đi chơi có vui không?	Did you enjoy going out?
em đỡ hơn	I am better (younger woman talking, health has improved);
Em hy vọng đội LA sẽ thắng	I hope the LA team will win
em không biết cách chèo	I don't know how to paddle
em không biết chèo (thuyền)	I don't know how to kayak
em không nhớ	I don't recall
em mua	I / you (younger person) buy
em	(my) young sibling
em nghĩ	I think
em nói chậm lại được không?	Please speak more slowly
em nói lại đi	Say it again
em nói nhanh quá!	You speak too quickly.
em ơi	Hey!
em ơi, tính tiền!	Hey you (but not considered rude like "hey you" would be in English) (waiter / waitress), bring me the check (calculation money)
Em Quy thân mến or Em Quy mến	dear Quy
em sai rồi	I was wrong
em sẽ thăm anh	I will visit you
em thích cả hai bằng nhau	I like both equally
em thuê giường	I rented a bed
em thường thức khuya	she usually gets up late
Em trả lời	I will answer
Em xong rồi	I finished
Em	younger sibling, for a slightly younger person, or for the woman in a romantic relationship. (S)
Florida trời thường nóng, nhưng VN trời nóng hơn	Florida is usually hot, but Vietnam is hotter
gần 3 năm rồi	Close to 3 years ago
gần	close/ near
gần	Close to
Gần đây có tiệm internet nào không?	Is there any internet shop near here?
gần lắm	Very close
gần nhà anh có công viên không?	Is there no park near your house?
gần Vịnh Hạ Long	Near Ha Long Bay
gặp	meet
gặp nhau	meet/see each other
gặp	to meet
giải thích/ giảng	explain / teach
giảm giá = bớt	Discount (literally 1: reduction price ; 2 cut)
giận dỗi	sulky
giận dỗi	sulky
giận dỗi	sulky
giao	affairs
giáo sư	professor
giáo viên dạy kèm	tutor
giáo viên	teacher
Gia thấy hơi lạnh	Gia feels a little cold?
giờ học	class
giờ	hour
giỏi lắm	Very good; very skilled
giỏi lắm	Very skilled
giới-thiệu	to introduce
giống nhau	the same
gió và mưa	Wind and rain
gió	wind
giùm	help
giường	bed
gì	what
gọi	Order (in a restaurant); also means "call"
gởi	send
Ha chưa thức dậy	Ha didn't get up yet
Ha đi chèo chuyền thuyền bao giờ chưa?	Did Ha ever go boating before?
Ha (đi) chèo thuyền ở Mỹ nhiều lần rồi.	Ha has been boating many times in America.
hai anh	you two
Hai chai bia	Two bottles of beer
Hai chị đi đâu đó?	Where are the two sisters going?
hai em	Two children or both children
hai mươi lăm	twenty five
hai mươi mốt (here the mốt not only doesn't have a nạng it has a sác).	Twenty one
hai mươi mốt	twenty one
hai mươi mốt	twenty one
hai mươi	twenty
hai mươi	twenty
hai nghìn không trăm mười bốn	2014
hai nghìn rưỡi đồng	2.500,00đ
Hải sản	Seafood
hai thôi	Only two
hai	two
hân hạnh được gặp ông	I'm pleased (to be able) to meet you. (Formal)
hân hạnh	to be happy, honored
Ha thích pizza ở tiệm khác	Ha likes pizza from different store
hạt	seed
hạt sen	Lotus seed
hát	sing
hầu hết	most
hay muộn hơn	or later
hay	or
hay	or
hẹn	appointment
Hẹn gặp anh lúc 9:30am.	See you at 9:30 a.m.
hẹn gặp lại anh!	Literally "appointment to see you again" - see you next time.
Hẹn gặp lại anh thứ 5.	See you Thursday
Hẹn gặp lại anh thứ ba lúc 9am nhe!	See you Tuesday at 9 a.m., ok! (Hẹn gặp lại = appointment meet back)
Hẹn gặp lại anh thứ bảy tuần sau!	See you next Saturday
Hẹn gặp lại anh thứ hai tuần sau lúc 9 giờ sáng	See you Monday next at 9 a.m. (tuần sau = week after = next week; tuần = week; sau = after)
Hẹn gặp lại anh thứ hai tuần sau	See you next Monday
Hẹn gặp lại	See you
Hẹn gặp	see
hên xui [hên used primarily in speech; not much in writing; mostly in the South, means lucky by itself, and xui means unlucky by itself]	It's hard to predict (that is, I don't know the answer because it's difficult to guess)
hè	summer
hiệu ăn	Restaurant (northern dialect)
hiệu	Shop, store (northern dialect)
hiệu = tiệm	store
hoặc = hay	or
hoặc	or
hoặc trà thảo mộc	Or herb tea
Hoa học lái xe hơi.	Hoa is learning to drive a car
học bao lâu?	Study how long?
học giỏi lắm	study very well
Học Physic có khó không?	Is studying physics difficult?
học	study
học	to study
học trò	School boy or school girl; pupil
hồi 6 giờ (use for stage, period)	Six o'clock (using word for at a particular stage or period)
Hội An có đẹp không?	Is Hoi An beautiful?
hỏi	Ask
hồi	category for periods of time
hôi	Foul or smelly
hơi lạnh = lạnh một chút	A bit cold
hơi mệt	tired
hồi nào	when (in the past)
hồi	period, time (Past)
hồi sáng nay (use for stage, period)	This morning (using word for at a particular stage or period)
Hội thoại	Conversation
hôm	day
hôm đó	That day
hôm hai mươi mốt tháng mười một	on the 21st of November
hôm kia	The day before yesterday
Hôm nay anh/chị đi thư viện lúc mấy giờ?	What time today did you go to the library?
Hôm nay là ngày mấy?	What dayof the month is it?
Hôm nay là thứ mấy?	Which day of the week is it?
hôm này	today
Hôm nay trời có lạnh không?	Today is it cold?
hôm qua anh có bài kiểm tra	Yesterday I had a test (in school)
hôm qua anh không có giờ ở phòng thí nghiệm	Yesterday I did not have any time in the lab
Hôm qua anh ở/ từ câu lạc bộ về (đến) nhà lúc mấy giờ?	Tomorrow, what time will you return home from the social club
Hôm qua không đi chèo thuyền, Ha có buồn không?	Yesterday you didn't go kayaking. Was Ha sad?
Hôm qua là ngày 6 tháng tám	Yesterday was August 6th
Hôm qua là ngày mấy?	What day of the month was yesterday?
Hôm qua là thứ mấy?	What day of the week is yesterday?
hôm qua là thứ tư	Yesterday was Wednesday
hôm qua tôi đi trường đại học	Yesterday I went to college
Hôm qua trời có nhiều gió?	Yesterday it (the sky / weather) was windy?
hôm qua	yesterday (day past)
hôm trước anh đi câu cá có vui không?	On the previous day you went fishing, was it fun?
hôm trước	the day before
hôn	kiss
hơn	More than
Họ	they
hy vọng	hope
Kem	Ice cream
kém	Less, used in minutes before the hour, as in quarter to six
kém (No.)	minus, be less than, inferior to, used in minutes before the hour, as in quarter to six
kế nhau	Adjacent (adjacent houses)
khác	other; different
khá lắm	Pretty much; fair
Khi anh còn nhỏ	when I was young
Khi nào anh mới đi câu cá?	When will you go fishing
khi vợ tôi thức dậy / also khi nào vợ tôi thức dậy	when my wife wakes up, or woke up;
khi	when
khoảng 100 mét	About 100 meters
khoảng 10 phút lái xe.	About 10 minutes drive
Khoảng 1 giờ trưa tôi về (nhà)	Around 1 o'clock (near noon time) I will return home
khoảng 1 năm	About 1 year
khoảng 25 người	About 25 people
khoảng 29 độ C	About 29 degrees C.
khoảng 2 tuần	about 2 weeks
khoảng 30 phút	About 30 minutes
khoảng 5 lần (rồi)	About 5 times (already)
khoảng	approximately
Khoảng ba giờ rưởi chiều mai tôi (sẽ) gặp ông ấy.	I'll meet him around 3:30 tomorrow afternoon.
khoảng một giờ trưa	Around 1 p.m.
Khoảng (ngày) mười lăm tháng sau/tới tôi về.	I'll return around the 15th of next month
khòe	health
khó lắm	very difficult
không bận lắm	Not very busy
không có gì	It's nothing (not have anything)
Không dễ	not easy
không đi nước ngoài	I didn't go to a foreign country
không làm việc qua điện thoại	Don't have to work on the telephone
không làm việc qua điện thoại	Don't have to work on the telephone
không làm việc qua điện thoại	Don't have to work on the telephone
không ngon lắm	Not very tasty
không ngon?	Not tasty?
không	no, not
không phải là	is not (so) (Lit. not so that it is...)
Không sao đâu.	It's ok.
Không sao đâu.	It's ok. No problem. (in response to apology)
không sao đâu	never mind
không thể	cannot
Không, tôi không buồn	No, I'm not sad
Không, tôi không buồn	No, I'm not sad
Không, tôi không buồn	No, I'm not sad
Không, tôi không học kinh tế vì khó lắm.	No, I'm not studying economics because it's very difficult.
không vui lắm	not very happy
Không xa.	Not far
khó nhưng vui (lắm)	difficult but fun (really)
khó tính	Difficult personality, picky
khó tính	Difficult personality, picky
khó tính	Difficult personality, picky
khứ hồi	Round trip
kia	(over) there
kiểm tra	Test (in school) or checkup (medical)
kiến trúc	architecture
kiến trúc sư	architect
kiến trúc sư	architect
là ban ngày ở Vn	is daytime in Vietnam
lá	Classifier smaller sheets of paper (letters, playing cards)
lại	again
lại	back
lại (biên lai = receipt; biên = record) (Rất vui gặp lại ông = nice to meet you again)	back or again
lái (xe)	Drive (car)
lái xe	Drive (car)
lái xe hơi	drive a car
lái xe	to drive
lăm	equal năm after mười or mươi (ex. mười lăm as fifteen or hai mươi lăm as twenty five).
Làm ơn cho tôi tiền thừa.	I'd like my change, please.
là một ngư dân	Was a fisherman
làm	to do, to work
làm việc bán thời gian	Work part time (literally half-time)
làm việc ở nhà.	Work from home
làm việc	work (Lit. do work)
lần đầu anh gặp Y ở đâu?	Where did you first meet Y
lần đầu	First time
lần đầu là năm nào?	What year was the first time?
Lần đầu tôi gặp Binh cách đây 5 năm.	I met Binh for the first time 5 years ago
Lần đầu tôi gặp Quan thứ hai ngày 16 tháng 11 năm 2009 ở khách sạn	I met Quan for the first time Monday, November 16, 2009, at a hotel.
là ngày ba mươi mốt tháng bảy	It is (or was) July 312
lạnh	cold
lạnh	cold
lạnh hơn	colder
lần sau anh sẽ thử	Next time I will try
lần sau	Next time
lập gia đình	Get married
lập gia đình/ kết hôn	married
là	to be, is, am, are
lâu lắm rồi	for a very long time
lâu rồi	long
lễ cưới	wedding
lễ đính hôn	Engagement [in Vietnam they have a big party for the engagement and get married as soon as a week later, or a few weeks]
lễ lớn	Big event (or holiday or feast)
lịch	calendar
lịch sự	polite
Linh hồn	soul
linh(no.), lẻ (so.)	zero between numbers in whole numbers
loại rau	Kind of vegetable (I think loại is a classifier word)
Loại Từ	classifier
lon bia 333 (ba ba ba)	Can of 333 beer
lon bia	Can of beer
lớn lắm	Very big
lớn	Large / great / heavy (loud as to music)
lớp	class , grade
lớp đó	That class
Luân Đôn	London
Luân-Đôn	London
luật	law
luật sư	lawyer
lúc 7: 30pm	At 7:30 p.m.
Lúc đó anh đến VN để làm gì?	That time you went to Vietnam to do what?
lúc đó	then
lúc	moment, at the moment of
lúc	time (or "at" a time)
lười biếng = làm biếng	lazy / idler
ly	Glass (for drinking)
ly kem	Glass of ice cream
mặc	clothing
mắc quá!	So expensive
Mắc quá!	That's too expensive.
mai = ngày mai	tomorrow
Mai tôi đi.	I will go tomorrow
Mã Lai	Malaysia
mạnh = mạnh khỏe	Strong / healthy
mạnh = mạnh khỏe	Strong / healthy
mạnh = mạnh khỏe	Strong / healthy
mạnh>< ốm/ bịnh	Strong >< ill/ sick
mạnh>< ốm/ bịnh	Strong >< ill/ sick
mạnh>< ốm/ bịnh	Strong >< ill/ sick
mạnh>< yếu	Strong >< weak
mạnh>< yếu	Strong >< weak
mạnh>< yếu	Strong >< weak
mặn	salt
Mất 15 phút lái xe.	It takes 15 minutes by car
mất 3 phút/ khoảng 3 phút	It takes 3 minutes / about 3 minutes
Mất bao lâu	how long
mất bao lâu?	How long does it take?
Mất bao nhiêu phút bằng taxi?	How long does it take by taxi/ ?
Mất bao nhiêu phút bằng xe ôm?	How long does it take by motorcycle taxi?
mát	cool
mát	cool
mát	Cool, fresh
mát hơn	cooler
mật ong	honey
màu	color
màu đen	Color black
màu hồng	pink
màu thu	color collection
màu vàng	yellow
màu xanh	green
mã vùng	zip code / postal code
mấy cốc?	How many cups?
Mấy giờ anh đi Sàigòn?	What time are you going to Saigon?
Mấy giờ anh ở/từ thư viện về nhà?	What time are you coming back from the library
Mấy giờ anh ở/từ thư viện về nhà?	When will you return home from the library?
Mấy giờ anh ở/từ thư viện về?	When will you return from the library?
Mấy giờ rồi, anh?	what time is it?
Mấy giờ sáng mai chị đi?	What time tomorrow morning will you go?
mấy giờ	what time?
mấy	how many
Mấy lần rồi?	How many times already?
mấy tuổi?	How old?
mẹ anh không khỏe lắm	My mother is not very well
mẹ Bill	mother of Bill
Mẹ/Má/Mợ	mother
mềm hơn?	More tender
mềm	Soft; with regard to beef - tender
miền Bắc	the North (the Red River Delta)
miền Nam	Southern region
mièn nam	Southern; Southern region
miền Nam	the South (the Mekong River Delta)
miễn phí	Duty free free of charge
miền	region
miền	region
(miền) Trung	Central Vietnam (Long mountainous region)
Mít	Jack-fruit - a fruit, can grow very large; green outside; inside there is an inedible white core surrounded by edible yellow or orange seed pods; the seed itself you don't eat (unless it's cooked and salted); grows in tropics, associated with India and Southeast Asia, but grows in Florida and Hawaii.
Mì	Yellow egg noodle soup
Mời anh đọc số 7. Mời can also mean invite. It's used as a polite way of telling someone to do something.	Please read number 7.
Mời anh đọc từ vựng	Please read the vocabulary
mỗi cuối tuần chúng tôi (đều) đi thăm bố mẹ	Every weekend we visit my parents
mỗi cuối tuần chúng tôi (đều) đi thăm bố mẹ	Every weekend we visit my parents
mỗi cuối tuần chúng tôi (đều) đi thăm bố mẹ	Every weekend we visit my parents
mời	invite
mỗi lần mấy cốc?	How many cups each time?
môi trường thiên nhiên	Natural environment
môi trường thiên nhiên	Natural environment
món cay	spicy
món chính	Main course
món	dish
mồng 1, mồng 10	First (word for days of month 1 - 10)
mỏng hơn	thinner
mồng	Precedes numbers 1-10 for days
món tráng miệng	Desserts (items coat mouth)
mốt (after mươi)	one
một chút	a little
một chút	a little
một chút	a little
một chút	A little
một chút	A little
một lần nữa	again
một ly nữa	Another glass
một mình thôi	alone
một ngàn/nghìn	1000
một nghìn chín trăm linh sáu	1906
một nghìn chín trăm sáu mươi	1960
(một) nghìn rưỡi	1500
một	one
một trăm	100
(một) trăm linh/lẻ ba	103
một trăm nghìn	100.000
(một) trăm rưỡi	150
một triệu	1.000.000
một triệu ba trăm lẻ bốn ngàn	one million three hundred and four thousand
một triệu rưỡi	1.500.000
Một trong những loại rau anh thích đó là Cải Thìa	One of the type of vegetables that I like is bok choy
một vạn	10.000
(một) vạn rưỡi/mười lăm nghìn	15.000
Mợ	wife of mother's younger brother.
mùa hè	In the summertime
mùa hè và màu thu	summer and autumn
mưa	rain
mùa	season
mùa thu	autumn
mua thức ăn	Buy food
mua thức ăn	Buy food
mua thức ăn	Buy food
Mực	Squid
mười ba	thirteen
mười bốn	fourteen
mười hai giờ rưỡi	Twelve thirty (time, using word "and a half")
mười hai	twelve
mươi	Increments of 10 after numbers :20,30...
mười lăm	fifteen
mười một	eleven
(Mười ngàn) được không?	I'll give you (10.000 dong).
muối	salt
mười	ten
muốn chị Tracy về nhà	Want Tracy to return home
muộn hơn	later
muộn/ trễ	late / delayed
mứt	jam
Mỹ	America
năm chấm hai	5.2 (five point two)
năm	five
năm (giờ) rưỡi chiều	5:30 p.m.
năm hai nghìn linh hai	the year 2002
năm nay còn 1 tháng nữa	One month more this year
năm nay	This year
năm ngoái anh đã đi nước nào?	Last year, what country did you go to?
năm ngoái	Last year
năm sau anh sẽ học tiếp	Next year I'll study more / continue to study / start studying again
năm sau= năm tới	Next year
năm trước / năm ngoái	Last year
năm	year
nào	which, what
nấu ăn	to cook
nấu Phở	Cook phở
này	this
này	this
Nếu anh không thể thức dậy sớm hơn, thì em sẽ thức khuya hơn	If you cannot wake up earlier, then I will stay up later
nếu có mưa thì mát hơn một chút	If it rains, then it's a little cooler
Nếu em đi Texas	If I go to Texas
Nếu . . . thì	If . . . then
Nga	Russia
ngày 20 tháng 1 năm 1980	January 20, 1980
ngày bảy tháng tám	August 7
ngày	day
ngày kia	Day after tomorrow
ngày mai anh sẽ đi tắm biển với Thao	Tomorrow I am going to visit the sea with Thao
Ngày mai em về VN.	Tomorrow I return to Vietnam
ngày mai là ngày 8 tháng 8	Tomorrow is August 8
ngày mai là ngày mấy?	What day of the month is tomorrow?
Ngày mai là thứ mấy?	What day of the week is tomorrow?
ngày mai mấy giờ anh đi câu cá?	Tomorrow, what time will you go fishing?
ngày mai tôi mới đi.	Tomorrow I will go
(ngày) mai	tomorrow
ngày mấy	which day of the month (date)
ngày mốt	The day after tomorrow
nghe	Listen (or hear)
nghe nói	heard
nghề	occupation
nghe rõ	Hear clearly
nghìn (No.), ngàn(so.)	(one) thousand
nghỉ	Vacation / cease / desist / halt
ngoại	foreign
ngoại giao	diplomacy
ngoài	outside
ngơi	rest
ngon hơn?	tastier
ngon quá!	Very delicious
Ngon (so chúc ngủ ngon, or goodnight, is "tasty sleep")	tasty
ngón tay anh bị đau	I hurt my finger
ngón tay anh	My finger(s)
ngón tay cái	thumb
ngón tay trỏ	Index finger
Ngon tuyệt!	Delicious!
ngọt	sweet
ngủ dậy = thức dậy	Wake up
người Hungary cũng (biết) làm bánh kếp	Hungarians also know how to make pancakes
người miền Nam	People in the Southern region
người nước nào?	Person of what nationality?
người nước nào	person of which country
Người	person, people
người ta	People / one
ngủ quên	oversleep
ngủ sớm, thức dậy sớm nhe!	Early to bed, early to rise
nhà anh	At my house
nhà anh số 555 dãy A tòa nhà 123 phố...	My home is number 555, building A, 123 street . . .
nhà ba mẹ anh	My parents' home
nhắc lại	repeat
nhạc lớn/ nhạc to/ nhạc ồn ào	Noisy music
nhạc	music
nhạc nước	Literally music water; a place in Singapore where they have decorative water and sound
nhà của em có bao nhiêu người?	How many people are in your family?
nhà em ở gần sân bay Tân Sơn Nhất	My home is near Tân Sơn Nhất airport (Saigon)
nhà hàng	restaurant
nhà hàng	restaurant
nhà	House, home
nhà khác	Other home
nhận	Accept or receive
Nha = nhé = nhe	Ok?
nhà thờ	church
Nhật	Japan
Nhật	Japan (Japanese)
Nhà tôi ăn bánh kếp với đường	At home I eat pancakes with sugar
nhà trọ	motel
Nhà vệ sinh ở đâu? (Vui lòng cho hỏi, nhà vệ sinh ở đâu?)	Where's the toilet?
nhé	all right?
nhé/ nhe/ nghe/ nha	Huh? No?
nhé = nhe = nha; example - Hẹn gặp lại anh thứ ba lúc 9am nhé)	all right? (you put it at the end of a sentence but by itself it doesn't literally mean anything)
nhe = nhé = nha	Right?
nhiều	A lot
nhiều	A lot
nhiều	A lot
nhiều gió	windy
nhiêu	Many; a lot
nhiều màu	many colors
nhờ	Ask or beg (for something); or be dependent on or have recourse to
nhỏ hơn	smaller
nhớ một ít	remember a little
nhớ	remember
nhưng anh bận rộn lắm.	But I'm very busy
Nhưng bây giờ	But now
Nhưng bây giờ vợ tôi ngủ dậy trễ nên tôi chưa được uống cà phê	But now my wife is sleeping late so I didn't have coffee yet
nhưng	but
nhưng	but
nhưng	but
nhưng	but
nhưng	but
nhưng em có thể ăn cay một ít	But she can eat spicy food a little
Nhưng Ha bình thường	But Ha is in a regular mood
nhưng không lái xe máy được.	But I don't drive a motorbike
nhưng không nóng bằng Vn	But not as hot as Vietnam
nhưng người Hungary ăn bánh kếp với thịt	but Hungarians eat pancakes with meat
nhưng tôi thích cà phê hơn	But I prefer coffee
Nhưng trong tuần (or ngày thường) chúng tôi ăn sáng lúc tám giờ.	But on the weekdays we eat breakfast at 8 o'clock
Nhưng vợ tôi nói thuyền	But my wife says that the boat . . .
nhưng vui lắm!	but very much fun
Nó có được bảo hành không?	Does it have a guarantee?
nói chuyện	speak
nổi danh	famous
nổi tiếng	celebrated
nói với/ nói chuyện với	Speak with
nóng hay lạnh	Hot or cold
nóng	hot
nóng	hot
nóng	hot
nữa	Another / half / semi
nửa đêm	midnight
nửa đêm	midnight
nữa	Further, besides, another, more
nửa	half
nửa	half
núi màu xanh	Blue Mountains
Nước cam	Orange juice
nước chanh	lemonade
Nước chanh	Lemon juice
Nước	country
nước Mỹ	The U.S.
Nước ngọt	Soft drinks
nước sâu (lắm)	Deep water (really)
Nước suối	Mineral
Nước trà/ trà đá	Tea / ice tea
nước	water
Nữu Ước (but New York may be understood better)	New York
ở	at, in on (Preposition)
ở đó	there
oi bức	muggy
ở khách sạn gần hồ Hoàn Kiếm	At a hotel near Hoàn Kiếm Lake
ở miền Đông Nam nước Mỹ	In the Southeast of the United States
ở miền Nam Florida có công viên quốc gia Everglades lớn lắm	In South Florida there is a large national park, the Everglades
Ở Mỹ chúng tôi thường uống cà phê với sữa tươi.	In America we drink coffee with fresh milk
Ở Mỹ khi anh đi hiệu ăn...	In America, when I go to a restaurant
ở Mỹ, người ta câu cá cho vui, giải trí	in the US, people fish for fun, entertainment
Ở Mỹ người ta thường uống..	In the US people often drink ..
ồn ào	noisy
Ông ấy đi năm một nghìn chín trăm lẻ sáu.	He came in 1906.
ông ấy	he (that man)
Ông bà ăn ở ngoài/ ở hiệu ăn.	They (parent age) eat out (in restaurants)
Ông bà sống ở đâu?	They (respectful, as in my parents) live where?
Ông của Ha	Ha's grandfather
Ông	grandfather, used as a term of respect for a man senior to the speaker and who is late middle age or older
ông	Mr., you, your; Sir (literally, 'my grandfather')
Ở nhà hàng có đông không?	Is it crowded at the restaurant?
ồn	noise
ớt	chili
ở trong phòng	In the room
ở trường đại học kiến trúc	At the architectural university
ở/từ Place1 đến Place2	from place1 to place2
ở VN ngoài phố/ ngoài đường có nhiều bụi.	in Vietnam, outside the streets are very dusty
Ở VN , người ta câu cá để ăn	In Vietnam people fish to eat
phải	have to / must
phải không?	Is it not so? (Lit. be correct, no?)
phải	must
phải	to be true, correct
Phan Chu Trinh ở Việt Nam đi / sang Nhật (từ) bao giờ? (đi = sang)	When did Phan Chu Trinh go from Vietnam to Japan?
Phan Chu Trinh từ Vn đi Nhật bao giờ?	When did Phan Chu Trinh go from Vietnam to Japan?
Phần C	Part C
Pháp	France (French)
phim	film
Phở bò	Beef Phở
Phở	Flat rice noodle soup
phố (northern dialect)	street
Phở tái	Phở with rare beef
phở	Vietnamese rice noodle soup
phố Vịnh Bờ biển	Gulf Shore Boulevard
phụ nữ	woman
quả chuối	Banana
quá = lắm	Very or too
Quán Bar	Bar
Quán cà phê	Coffee shop
quận	region
quận Tân Phú	Tân Phú region
qua skype	By Skype
quá!	too
quả/trái	Classifier used for globular objects (the Earth, fruits)
qua	Via / by / over
quầy bar	Bar (place where alcohol is served at a counter)
quên hết	forget
Quy có thích ăn cay không?	Does Quy like spicy food?
quyển/cuốn	Classifier word used for book-like objects (books, journals, etc.)
quyển sách	A book
rảnh không?	are you available; do you have time now?
Ra	out
ra trường / tốt nghiệp	to finish (leave) school, graduate, graduated graduation; tốt = good; nghiệp = industry
rất	very much
Rất vui được gặp anh!	It's nice to meet you.
Rất vui được gặp chị	Pleased to meet you
rau đó ngon lắm	that vegetable is delicious
rau đó	that vegetable
rõ	clear
rõ	clear
rõ	clear
rõ	clearly
rõ	Clear or clearly
rồi	already
rồi	Already / also used to make a verb past tense
Rồi, anh đi 1 lần rồi.	Yes, I went one time
rõ lắm	very clear
rùa	turtle
rưỡi	A half or "and a half," with numbers, like 150 is trăm rưỡi ỏ môt trăm rưỡi
rưởi	half past, and a half ( For numbers under 100)
Rượu	Wine
Sai	wrong
Sa lát	Salad
sân bay	airport
sáng hôm qua	Yesterday morning
Sáng mai chị đi lúc mấy giờ?	Tomorrow morning at what time will you go?
sáng mai lúc chín giờ	Tomorrow morning at nine o'clock
sáng	morning
sáng	morning
sáng	từ 2:00 am đến 10:00 am
sao đâu	ok
sao	how
sắp	to be about to
sau 4 ngày	After 4 days
Sau	after
sau	After or next
sáu chấm một	6.1
sau đó	After that
sau đó	After that
Sau đó	After that
sau đó	then
Sau đó, tôi học tiếng Việt với em / qua skype được 2 tháng.	After that, I studied Vietnamese with you / by Skype for 2 months
sau khi	after
Sầu Riêng	Durian - a kind of fruit. It's large and the outside may have many dull spikes; inside they have large sections; some people think it smells bad
Sầu riêng	Durian; the husk is covered with thorns; the smell is very strong; they can grow as large as 12 inches long and 6 inches in diameter; they typicall weight 2 - 7 pounds; the color of the husk is green to brown, and the flesh inside is pale yellow to red, depending on the species.
sáu	six
sẽ đi chèo thuyền	Will go kayaking
sẽ gặp lại	Will meet again
sen	lotus
sẽ	Will / are going to / [makes verbs future tense]
sẽ	will, shall
sinh/sanh	to be born
sinh viên	tertiary student
si - rô cây Thích	maple syrup
số 1	Number 1
số điện thoại của anh là số mấy?	What's your phone number?
số điện thoại (của) anh là	Your telephone number is
sở làm/ chỗ làm/ công ty (any of these by itself could mean office also)	Office / workplace / company / office
sở làm = chỗ làm = công ty	Work (place of work) / company
sở làm	Office where one works
số mấy	what number
sớm hơn	earlier
sớm hơn	earlier
sống	to live
sống với gia đình chồng	Lives with her husband's family
số	number
sữa bột	Powdered milk; baby formula
sữa đặc	condensed milk
sữa đặc	Condensed milk
sữa	milk
sữa	milk
sữa nóng	Hot milk
sữa tươi	Fresh milk
sức khỏe	health
sử dụng = dùng	To employ or use; user
tại sao anh không đi chèo thuyền?	why did you not go paddle a boat?
tại sao	why
tại vì anh phải đi	Because you have to go
Taị vì	because
tại vì Ha có giờ học tiếng Anh buổi sáng.	because Ha has English class in the morning
Tạm biệt! Chào tạm biệt.	Good bye!
tám	eight
Tám giờ rữơi sáng mai tôi đi.	I'll go at 8:30 tomorrow morning
tâm	Heart or soul
tâm hồn	soul
tám trăm tám mươi bảy	887
Tan là người đạo Phật	Tan is a Buddhist
Tan theo đạo Phật	Tan is a Buddhist (follows path Buddha)
tất cả	all
Tàu	Chinese (colloquial)
tay anh bị bong gân	I sprained my hand ("hand my suffered sprain")
Tây Ban Nha	Spain
Tây Nam	Southwest
tên anh	your name: name of you (Mr., older brother)
Tên bà là gì?	What is your name?
tên bà	your name: name of you (Mrs.)
Tên của cô ấy là Y, nhưng bây giờ là Z.	Her name was Y, but now her name is Z.
tên	given name
Tên Mỹ của ____ là _____	Her American name is ____
Tên ở Mỹ của ____ là _____	Her American name is _______
tên ông là gì	What's your name (older man)
Tên tôi là Hà.	My name is Ha
tên tôi	my name: name of me, name of mine
Thái Lan	Thailand
thăm bạn	to visit a friend
thăm	to visit
thăm	visit
Thân chào	dear
Thân	Dear
thắng ai?	They beat whom (soccer game)?
tháng ba Vietnamese/lunar calender	third month / March (Western calender equivalent)
tháng bảy Vietnamese/lunar calender	seventh month / July (Western calender equivalent)
tháng chạp	December (in lunar calendar)
tháng chạp Vietnamese/lunar calender	twelfth month / December (Western calender equivalent)
tháng chín Vietnamese/lunar calender	ninth month / September (Western calender equivalent)
thắng đội nào?	Which team?
tháng giêng/một Vietnamese/lunar calender	the first month / January (Western calender equivalent)
tháng hai Vietnamese/lunar calender	second month / February (Western calender equivalent)
tháng	month
tháng	month
tháng mười hai Vietnamese/lunar calender	twelfth month / (Western calender equivalent)December (Western calender equivalent)
tháng mười một Vietnamese/lunar calender	eleventh month / November (Western calender equivalent)
tháng mười Vietnamese/lunar calender	tenth month / October (Western calender equivalent)
tháng năm Vietnamese/lunar calender	fifth month / May (Western calender equivalent)
tháng này không nóng lắm	This month is not very hot
tháng này	This month
Tháng sau là tháng mấy?	What month is next month?
tháng sau	Next month
tháng sáu Vietnamese/lunar calender	sixth month / June (Western calender equivalent)
tháng tám Vietnamese/lunar calender	eighth month / August (Western calender equivalent)
Tháng tới/ sau tôi về.	I will return next month
tháng trước	last month
tháng trước	Last month
tháng trước	Last month
tháng trước nóng	Last month was hot
Tháng tư	April
tháng tư	the fourth month, April
tháng tư Vietnamese/lunar calender	fourth month / April (Western calender equivalent)
thắng	win
thắng	win
thành phố	city
thành phố	city
Thân	Like we use "dear" at the beginning of a letter, and also means "sincerely" at the end of a letter
thật	very
thật vui	Very fun or very happy
thầy giáo	male teacher
thầy	male teacher
thầy	Male teacher
thế à	Indeed!
Thế à?	Is that so?
thế à? vậy à?	really?
thẻ	card
Thêm một cái nữa	Same again
thêm	Verb "to add" or adjective "additional" or "added"
thế nào?	How?
thẻ tín	Credit card
Thế / vậy	So or therefore
thế/ vậy / vì vậy	So / therefore
thích ăn Phở lắm!	Like phở a lot
thích	Like (enjoy)
Thích Nhất Hạnh	Love of the highest kind; Thich Nhat Hanh
thích trà hơn.	I like tea more (than coffee)
thiếu (So.)	minus, be insufficient
Thím	wife of father's younger brother.
thỉnh thoảng	occasionally
Thịt bò	Beef
thịt bò / bò	beef
thịt	Flesh / meat
Thịt gà	Chicken
Thịt heo	Pork
Thôi / dừng	stop
thôi	stop
thôi,...	That's all. Well,..
Thôi	That's all. Well...
thối / thúi	Verb - to rot; adjective: smelly
thời tiết hôm nay nóng	The weather is hot today
thời tiết không tốt để đi biển	The weather is not good for going to the beach
thời tiết	Weather
thua	lose
thua>< thắng	lose>< win
thứ ba	Tuesday
Thứ bảy	Saturday
thức ăn cay	Spicy food
thức ăn cay	Spicy food
thức dậy	wake up
thức dậy	Wake up
thức dậy	Wake up
Thực đơn	Menu
thứ	Day of the week
Thứ Hai	Monday
thứ hai tuần sau	Next Monday (day two week next)
thứ hai tuần thứ hai tuần tới	Next Monday
thứ mấy	which day (of the week)
Thứ Năm	Thursday
Thứ năm tuần sau là ngày mấy?	Next Thursday is what date?
Thứ năm tuần trước là ngày mấy?	What date was last Thursday?
thú nuôi / thú cưng	Pet (animal)
thương gia	Merchant, businessman, businesswoman
thượng lộ bình an	Have a prosperous trip; have a safe trip; bon voyage
thương mại	Commercial; trade
thường	often
thường thì không	Usually not
thương	Trade, commerce
thường uống	usually drink
thường	usually
thường	usually
Thứ Sáu	Friday
thứ sáu này	This Friday
thứ	Thing (like things to do, things to buy)
thử	try
Thứ tư	Wednesday
thư viện	library
thư viện Pháp	French library
thư viện Pháp	French library
thuyền	Boat
thuyền có hôi không?	Was the boat smelly
tiệm ăn	Restaurant (Southern dialect)
tiệm Phở	Noodle shop
tiệm	Shop, store (Southern dialect)
tiếng Pháp năm thứ nhất	First year French student; (language French year ordinal one)
tiếng Tây ban Nha	Spanish
tiền thối lại	Change (excess money back, literally money excess back)
tiền thừa	Change (excess cash; money returned to you after paying
tiếp	Next/ more/ with verb to mean "begin again"
tiếp tục	continue
tiều bang	State
tiểu bang	state
tiểu bang	state
tiêu	pepper
tiểu	primary
Tìm / tìm kiêm	seek
tín	credit
tính	character
tính	character
tính	character
tỉnh	province
tính tiền đi (đi at the end of the sentence implies pushing someone to do something	Bring me the bill / check (this way of asking is pushy, not polite)
tình yêu	lover
TIn Lành	Protestant
tòa	building
tòa	Classifier buildings of authority: courts, halls, "ivory towers".
to	Big / heavy (loud as to music)
tờ	Classifier sheets and other thin objects made of paper (newspapers, papers, calendars, etc.)
tối	be dark, evening, after dark
Tôi chỉ xem thôi.	I'm just looking.
Tôi chưa biết, nhưng có lẽ khoảng 4 tiếng.	I don't know yet, but maybe around 4 hours
tôi chưa thử bao giờ / tôi chưa bao giờ thử	I never tried
Tôi có thể mặc thử được không?	Can I try it on?
Tôi có thể sử dụng nó/ cái này được không?	Could I use it/ this?
Tôi có thể xem không?	Can I look at it?
tôi cũng hy vọng vậy	I also hope so
tôi cũng vậy	Me too
Tôi đang nói chuyện với cô Y	I'm speaking with teacher Y or with aunt Y
Tôi (đang) nói với cô Y.	I'm speaking with Y
Tôi đi học	I go to school (as a regular activity) or I go study (now).
Tôi đi lúc một giờ. Tôi ở thư viện từ một giờ đến năm giờ nhưng tôi không gặp ông Hai.	I went at one o'clock. I was at the library from one o'clock until five o'clock, but I didn't meet Mr. Hai
Tôi đi nhà bạn tôi	I go (am going, went) to my friend's house
Tôi đi văn phòng công ty	I'm going to the office (the corporate office)
Tôi đói bụng.	I'm hungry
Tôi đón Y ở Sài Gòn để đem Y đi Mỹ	I picked up Y in Saigon to bring her to America
tối	evening
Tôi hiểu	I understand.
Tôi học (được) hai năm.	I studied for two years.
tôi học ở University X được 2 năm	I studied at University X for 2 years
Tôi học tiếng Việt bằng chương trình Pimsleur, được một ít.	I studied Vietnamese by the Pimsleur program, learning it a bit
Tôi học tiếng Việt (được) năm tháng rồi	I've been studying Vietnamese language for five months.
tối hôm qua anh đi ngủ lúc 12:30	Last night I went to bed at 12:30
Tội hôm qua anh ngủ có ngon không?	Yesterday evening did you have a good sleep?
tối hôm qua	Last night; yesterday evening
tôi	I
Tôi	I or me
Tôi khát nước.	I'm thirsty
Tôi không biết rõ lắm.	I don't know him very well.
Tôi không biết rõ lắm.	I don't know him very well.
Tôi không biết rõ lắm.	I don't know him very well.
Tôi không hiểu	I don't understand.
Tôi lái xe hơi được	I can drive a car
tối mai	This evening
Tôi mới lập gia đình 4 năm.	I just got married 4 years ago
tôi	my, I
Tối nay tôi sẽ đi xem phim.	I am going to a movie tonight.
Tôi no rồi!	I'm full.
Tôi sẽ đi miền Nam sau khi thăm gia đình vợ	I will go to the southern region after visiting my wife's family
Tôi sẽ ở Hà Nội	I will be in Hà Nội
Tôi (sẽ) ở/ từ thư viện về khoảng/ chừng một giờ trưa	I will return from the library around 1 p.m.
Tôi (sẽ) ở/ từ thư viện về khoảng/ chừng một giờ trưa.	I will return from the library around 1 p.m.
Tôi sinh ngày __ tháng __ năm ____	I was born ________ [date]
Tôi sống ở Sài Gòn	I live in Saigon
tôi thích buổi sáng hơn	I prefer morning
Tôi thích cả 2	I like both
Tôi thường đến lớp sớm hay muộn	I often come to class early or late
Tôi thường uống cà phê nóng nhưng mùa hè tôi thích uống cà phê đá	I usually drink hot coffee but in the summertime I like to drink iced coffee
tới / tôi / tối	Next / I / evening
Tôi trả bằng thẻ tín dụng được không?	Is it ok if I pay using a credit card?
tối	từ 7:00p.m đến 9:00pm
tôi tự học ở nhà một chút	I studied by myself at home a little
tôi vui	I'm happy
tôi vui	I'm happy
tôi vui	I'm happy
Tôm	Shrimp
tốt nghiệp	Graduation (tốt =good; nghiệp = industry)
trà đá	Iced tea
Trái chuối	banana
trái vải	Lychee
trả lời	answer
trăm	(one) hundred
Tráng miệng	Desserts
trắng	white
trả	pay
trà Pháp hoặc trà Trung Quốc	French tea or Chinese tea
trà (so.); chè (no.)	tea
trẻ hơn anh nhiều	Much younger than you (or than me or than older brother)
trẻ hơn	younger
trễ	late
trễ	late
trễ	late
trên	On
tròi có nhiều gió	The weather is windy
trời mưa	rain
trời nóng hay mát?	Is the weather hot or cold?
trời nóng	Hot weather (hot air or hot sky)
Trời ơi, as in Trời ơi Are you crazy? Or Trời ơi. Em đẹp kinh khung. (You look so beautiful)	Literally Sky or supernatural plus function word for calling someone. Used to express surprise or strong impression like oh my God or my goodness.
trời	sky
trời	Sky / heaven / weather
trời tuyết	snow
Trong lòng X	Inside X's heart
trong tuần / ngày thường	During the week (weekdays)
trở về	return
trưa mai	Tomorrow noon
trưa	Mid-day
trưa	midday, noon
trưa	noon
trưa	noon
trưa	noon
trưa	từ 11:00am đến 2:00pm
trước	before, previously
trước	Before, previously
trước	Before; previously
trước	before, the...before
trước khi	before
trước ngày	Previous day
Trước, tôi ở vùng Hawthorne.	I lived in Hawthorne before.
trường đại học kiến trúc	Architectural university
trường đại học kiến trúc	Architectural university
trường đại học	university
trường đại học	university
trường (học)	school
trường	school
từ 12 giờ đến 6 giờ chiều?	From noon until 6 p.m.
từ 21/ 11 đến 3/12	From 21/11 to 3/12
tuần này	This week
tuần sau	Next week (week after)
tuần trước	Last week
tuần	week
tuần	week
tuần	week
từ . . . đến	From . . . to
từ...đến...	From . . . to
từ ..đến	from . . . Until
từ	from
Từ	from, since
Tự kiểm tra	Self-test
từ ngày mười bốn đến ngày hai mươi bốn tháng mười hai	From December 14 to 24
từ nhà anh đến biển bao xa?	How far is your home from the sea?
từ Nha Trang đến	from Nha Trang to
từ Nha Trang về	From Nha Trang to
tuổi	age
tuổi	age
tươi	fresh
từ SaiGon đi Sing mất 1 tiếng 35 phút	From Saigon to Singapore takes 1 hour 35 minutes
tự	self
tự	self;
từ số 1 đến số 5	From number 1 to number 5
từ Việt Nam đi Sin-ga-po/ở Việt-Nam đi Sin-ga-po	From Vietnam to Singapore
tùy anh	It depends on (is up to) you
Tùy anh	It's up to you (depending you)
tỷ	billion
Úc	Australia
uống	drink
uống	drink
uống trà	Drink tea
và	and
và cả nhà	And all the family
và Hội An	And Hoi An
vẫn ấm hơn Chicago	still warmer than Chicago
Vâng, chúng tôi rất hạnh phúc.	Yes, we are very happy
Vâng/ có	yes
vâng	yes, that's right
vạn (một vạn)	10,000
vẫn	still
vẫn	still
vào cuối tuần	On the weekend
vào	Enter; go to
vào năm...	In what year
vào	On / in / at
Vào sổ lám	Go to the workplace (or "in the workplace")
Và tháng sau/tới tôi (sẽ) bắt đầu học lịch sử Việt Nam.	and next month I'll begin studying Vietnamese history.
vật lý	physics
vật lý	physics
vật lý	physics
và uống cà Phê	And drink coffee
vậy anh sẽ đi bộ hay đi xe?	So you would walk or drive?
Vậy anh sẽ đi VN tháng 12 năm nay?	So, you are going to go to Vietnam which day in December?
(Vậy) chị làm từ ba giờ đến mấy giờ?	So you work from 3 o'clock until when?
(Vậy) chị làm từ ba giờ đến mấy giờ?	So you work from 3 o'clock until when?
Vậy chị là viên chức à/ phải không?	So, she is a public servant, right?
vậy	so
vậy	So
vậy	So, as in "so you work until when"
vậy	So or therefore
/ vậy/ thế?	So
vậy/thế	therefore
Vậy Y ở Mỹ được 4 năm rồi.	So Y has been in the U.S. for 4 years.
về...lúc mấy giờ	What time did you return?
vé máy bay bao nhiêu tiền?	How much is an airplane ticket?
về nhà	Return home
vé	ticket
về	To return; to come back
về	to return (to), return home
vì anh có nhiều việc phải làm	Because you had work
vì anh phải làm nhiều việc	Because you had to do a lot of work
việc	Classifier an event or an ongoing process
viên chức/ công chức	public servant, official, civil servant
"viết" là gì? [it means "write]	what does "viết" mean?
Việt (Nam)	Vietnamese, Vietnam
vì Hải	Because of Hải
vì máy bay bị trễ	Because the plane is late
vì máy bay bị trễ	Because the plane is late
vì máy bay bị trễ	Because the plane is late
Vịnh	Bay
Vịnh Mexico	Gulf of Mexico
vì ở Sing có nhiều cây và biển	Because in Singapore there are many trees and ocean
vì thịt bò mềm hơn?	Because the beef is more tender
vì vợ tôi	Because of my wife
Vợ anh có đi làm không?	Is your wife going to work?
Vợ anh/ Em ấy	My wife / she
vợ anh lau chùi	My wife cleaned
vợ anh	My wife
vợ anh	My wife, your wife, older brother's wife
vợ chồng anh đi chơi	My wife and I are going out
vợ chồng tôi uống cà phê mỗi ngày.	My wife and I drink coffee every day
Vợ của anh tên là Y phải không?	Your wife's name is Y, no?
với đường không?	with or without sugar?
với sữa đặc?	With condensed milk?
với sữa hay không sữa	with or without milk
với	with
vợ tôi chưa ngủ dậy/ chưa thức dậy	My wife has not yet woken up
Vợ tôi thường làm cà phê cho tôi	My wife usually makes coffee for me
Vợ tôi thường làm cà phê	My wife usually makes coffee
vợ tôi và tôi	My wife and I
(vừa) mới	Only just [ refers to an action that seems recent to the speaker; it can be something that recently happened, but recent can mean in minutes, days or years; it also can refer to actions in the future, as in, he'll
vui	fun
vui	happy
vui lắm	very fun
Vui lòng chờ một lát/ đợi một chút.	Please wait a moment.
Vui lòng nói chậm lại.	Can you speak slow down please?
Vui lòng nói lại một lần nữa.	Can you speak again please?
vui lòng nói lại một lần nữa	Please say it again
Vui lòng tính tiền	Bill, please!
vui tính	cheerful
vui tính	cheerful
vui tính	cheerful
vùng	area, suburb
vùng	neighborhood
vùng	Region (e.g. south or north)
xa	far
xa	far
Xanh da trỏi	(sky) blue
Xanh lá cáy	(tree) green
xấu (không đẹp would be les strong)	Ugly
xấu (không đẹp would be les strong)	Ugly
xấu (không đẹp would be les strong)	Ugly
xe	car
xem phim	to see a movie
xem phim	Watch a movie
xem	to look at
xem	view
Xin chào!	Hello!
Xin chỉ giùm phố ... ở đâu?	Please show me where is _________ street
Xin chỉ giùm trên bản đồ?	Can you show me on the map?
xin em nói chậm lại	Please speak more slowly
Xin giới thiệu	Please let me introduce you.
XIn lỗi anh, anh chờ em 5 phút nhe!	Excuse me; wait for me 5 minutes please
xin lỗi	beg pardon (of you), excuse me
XIn lỗi em, anh trễ.	sorry I'm late
Xin lỗi	Excuse me
xin lỗi ông	Excuse me (older man)
Xin lỗi	Sorry
xin nói chậm lại	Please speak more slowly
xin	to request
Xoài	Mango
xoay	turn
xuất huyết não	cerebral hemorrhage (going out [export; drain] blood brain)
yên tĩnh	quiet
yêu	love
