aave	love
aazv	etcetera
abi	at least
Abi gezunt!	As long as you're healthy!
a bisel	A little
a bisele	a tiny piece
A biseleh	a very little
a bisl	A little, a bit
abi ver	anybody
abi vos	anything
abi vu	any way
abonanament	subscription
abonant	subscriber
abonent	subscriber
abonirn	subscribe to
abort	abortion
abrashe	Abrashe (name)
A breyre hob ich	I have no alternative
A breyte deye hob'n	To do all the talking
A brocheh	A blessing
A broch!	Oh hell!
A broch tzu Columbus	A curse on Columbus
A broch tzu dir!	A curse on you!
absolut	absolute
abstrakt	abstract
abstraktsye	abstraction
absurd	absurd
A chazer bleibt a chazer	A pig remains a pig
A choleryeh ahf dir!	A plague on you!
A chorbn	Oh; what a disaster
Achrahyes	Responsibility
acht	eight
achtsik	eighty
achtsn	eighteen
a dank aych	thank you
a dank dir	thank you
A dank	Thank you
A dank!	Thank you very much!
adaptirer	adapter
adaptirn	adapt
adaptsye	adaptation
adayem	to this day
A deigeh hob ich	I don't care
aderabe	on the contrary
adir	wealthy person
adldik	noble
adl	nobility
administrative	administrative
administratsye	administration
adoyni	Mister
adoyn	Mister
adrabe	on the contrary
adurkhhaltn	hold out
adurkhhgeyn	go through
adurkhkukn	look through
adurkhlebn	live through
adurkhn	look through
adurkhshmuesn	discuss
adurkh	through
adurkhtsufirn	accomplish
adurkhvetshn	squeeze through
adverb	adverb
advokat	lawyer
adye	adieu
adyé	goodbye
adyektiv	adjective
aeroplan	airplane
aeroport	Airport
A farshlepteh krenk	A chronic ailment
A feier zol im trefen	He should burn up!
afikoymen	afikomon
afile	even
afish	poster
Afn gonif brennt das hittel	He thinks everyone knows
A foiler tut in tsveyen	A lazy person has to do a task
A fraylekhn Pesah	Happy Easter
a freylekhn peysekh!	Have a happy Passover!
a freylekhn yontev!	Have a happy Holiday!
a freylekhn yontev sukes!	Have a happy Sukkoth Holiday!
afrikaner	African (male)
afrikanerin	African (female)
afrikanish	African
afrike	Africa
agent	agent
agentur far gedungene oytos	Car rental agency
A gesheft hob nicht	I don't care
agev	incidentally
A gezunt ahf dein kop!	Good health to you
A git yor	Happy New Year
A glick ahf dir!	Good luck to you
A glick hot dich getrofen!	Big deal!
A gliklekhe rayze!	Bon voyage!
A gliklekhn yortog	Happy anniversary
A gliklikhn Mutertog	Happy Mother's Day
agmes	anguish
agmes nefesh	grief
agole	hearse
agrafke	safety pin
agres	gooseberry
agresiye	aggression
agresor	aggressor
A groyser tzuleyger	A big shot
A grubber yung	A coarse young man
agune	woman whose man disappeared
A gute nakht!	Good night!
A gute nakht un zise droymer!	Good night &amp; sweet dreams!
A gutn ovent	Good afternoon
A gutn tog!	Good day
a gut ovnt	Good evening
A gut yor!	Happy New Year!
aher	here
aheym	homeward
Ahf zu lochis	Spitefully
ahinter	backward
ahin	there
ahkile	eating
ahklen	eat
Ahntoisht	Disappointed
Ahzes ponim	Impudent fellow
Aidel	Cultured or finicky
Aidel gepotchket	Delicately brought up
Ainikle	Grandchild
Aitzeh	Advice
Aiver butelt	mixed up
akademish	academic
akademye	academy
A kappore	A catastrophe
a kayme lon fun	no less than
akdomes	Akdomuth
akegn	against
akern	plow
aker	plow
akeyde	sacrifice
akh	ah!
akhashveyresh	Ahasuerus
akhdes	unity
akhrayes	responsibility
akhren akhren khovev	last but not least
akhrun	last
akhte	eight o'clock
akht	eight, eighth
akhtl	eighth
akhtsik	eighty
akhtsn	eighteen
akhtung!	attention!
akhtung	respect
akhtung ton	pay attention
akhuts	except
akhzer	brute
akhzorim	brute
a kitser	in short
a klal	in short
a klap ton mit	smack
A klog iz mir!	Woe is me!, Woe is me! (1)
akord	chord (in music)
akore	barren woman
akrobatik	acrobatics
aks	axle
akshn	stubborn
aksl	shoulder
akt	deed
aktiv	active
aktivitet	activity
aktrise	actress
aktsent	accent
aktsye	share of money
aktuel	timely
aktyor	actor
Alaichem sholom	To you be peace
A langer lucksh	A tall person
albanye	Albania
albert	Albert
alding	everything
A leben ahf dir!	And be well!
alef	alef; 1st letter of alphabet
Alef bais	Alphabet
alef beys	alphabet
alefbeys	alphabet
alemen	everything
alemol	all the time
alerley	all kinds of
ales	All
alevay	If only...
ale vayle	all the while
alevay vayter	so good
Alevei!	It should happen to me
aleyn	alone
algemeyn	general
algemeynkayt	generality
aliirt	allied (with)
aliye	immigration to Israel
alklponem	at any rate
alkolponem	at any rate
Alle ziben glicken	Not what it's cracked up to be
almen	widower
almer	closet
almone	widow
al pi	according to
alpi	according to
al pi rov	mostly
Alrightnikeh	Feminine form of alrightnik
Alrightnik	One who has succeeded
als	as
altdaytsh	old German language
Alteh moid	old maid
alte moyd	old maid
Alter bocher	Bachelor
Alter bok	Old goat
alterheyt	in old age
alter kaker	old geezer
Alter Kocker	An old man or old woman
alter	old man
altetshke	old woman
altetshker	old man
altkeyt	old age
alt	old
altsding	everything
alts	everything
alts mer	all the more
altyidish	Old Yiddish
aluminium	aluminum
A lung un leber oyf der noz	Stop talking yourself into ill
alveltlekh	universal
a makh ton mit der hant	wave
amator	amatuer
ambrozye	ambrosia
ambulans	ambulance
A mehaye	Wonderful
ameratses	ignorance
ameratsim	ignorant person
ameratsish	ignorant
amerikaner	American
amerikanish	American
amerike	America
amer	thus
A metsieh far a ganef	It's a steal
amolik	former
amol	past
a mol	sometimes
A moment; ikh bet dikh!	One moment please!
amorets	ignorant person
ampern zikh	argue
amsterdam	Amsterdam
amtirn	serve (in office)
amt	office (position)
amuzirin zikh	have a good time
amuzirn	amuse
am yisroel	people of Israel
A nahr bleibt a nahr	A fool remains a fool
an akt fun der velt	unheard of
analiz	analysis
analizirn	analyze
An alteh machashaifeh	An old witch
An alter bakahnter	An old acquaintance
An alter trombenick	An old bum
anander	each other
anarkhist	anarchist
anarkhistish	anarchistic
anatomie	anatomy
an aveyre	a waste of...
andere	others
ander	other
andersh	different
andert halb	one and a half
anderthalb	one and a half
A nechtiker tog!	Forget it!
anekdot	anecdote
An emmisse meisse	An absolutely true tale
an eygen	one of us
angstn	cold sweat
anider	down
anidershteln	put down
anisht	if not
A nishtikeit!	A nobody!
anit	if not
ankete	questionnaire
anons	advertisement
anonsirn	advertise
ansambl	ensemble
anshtot	instead of
antdekn	discover
anthaltn	contain
antik	antique
antkegngeshteln	oppose something
antkegngeshteln zikh	oppose
antkegn	opposite
antlofn	escaped
antloyf	escape
antloyfn	run away
antologye	anthology
antoyshn	disappoint
antoysht	disappointed
antoyshung	disappointment
antplekn	reveal
antshlofn vern	fall asleep
antshuldikn	excuse
antshuldikn zikh	apologize
Antshuldik(t)	Excuse me
antshuldikung	apology
antviklen	develop
antviklung	development
anulirn	cancel
anumltik	recent
anumlt	recently
anyogn	catch up with
A oygnblik; ikh bet dikh!	One moment please!
apel	appeal
apetit	appetite
Apikoros	An unbeliever
apikorses	heresy
apikorsim	heretic
apikorsish	heretical
apikoyres	heretic
A piste kayleh	A shallow person
aplikatsye	application
a ponem	apparently
aponem	apparently
a por	a few
april	April
apteyker	pharmacist
apteyk	Pharmacy
araber	Arab (person)
arabish	Arabic
arabye	Arabia
aranzhirn	arrange
aranzhirung	arrangement
araynbrekhn zikh in	break into
arayndringer	invader
araynfaln in di reyd	interrupt (1)
araynfir	introduction
araynfirn	lead in
arayngang	entrance
arayngebn	place
arayngenumen	included
arayngeyn	go in
arayngrobn	dig into
arayn	in
araynkhapn	snatch
araynklapn	knock in
araynkrign (zikh)	get oneself in
araynkukn	look in
araynkumen	come in
araynleygn	put in
araynlozn	allow in
araynmishn zikh	mix in
araynnemen	take in
araynraysn zikh in	break into
araynshteln	put in
arayntretn in	join a group
arayntsien	draw
araynvarfn	throw in
araynzetsn	put somthing in
araynzogn	tell off
araytretn	step into
arbes	pea, chickpea
arbeter	worker
arbet	labor
arbetn	work
Arbit	Work
arbldik	sleeved
arbl	sleeve
A?	really!
Arein	Come in!
arende	lease
arestant	prisoner
arestirn	arrest (someone)
ariber	above
ariberfirn	transport
aribergebn	give over
ariberkhapn	carry somtheing to excess
aribershpringen	jump over
aribershtaygn	surpass
arikhes yomim	longevity
aristokrat	aristocrat
aristokratish	aristocratic
A ritch in kop	Crazy
arkhitekt	architect
arkhitektur	architecture
arkhiv	archives
armey	army
arn	Aaron, concern
Aroisgevorfene gelt	Thrown out money
Aroisgevorfen	Thrown out
aromat	flavor
aromatish	aromatic
arop	Down, off
aropfaln bay zikh	lose heart
aropfaln	fall
aropgeyn	go down
aropkhapn	snatch down
aroplozn	turn down
aropnemen	take down
aropnidern	descend
aropshlingen	swallow
aroyfkrikhn oyf	climb
aroyfshikn	send up
aroyf	Up, upward
aroyfvarfn	throw up
aroynes	coffin
aroysbalotirn	vote out
aroysbrengen	bring out
aroysfor	departure
aroysforn	depart
aroysfvarfn	throw out
aroysgang	exit
aroysgebn	release
aroysgeyn	go out
aroyshelfn	assist
aroysheybndik	beginning
aroysheybn	pick out
aroyskhapn	snatch
aroysklaybn zikh	move out of a house
aroyskrign	exact
aroyskumen	come out
aroysnarn	get by deception
aroys	out
aroysraysn	pull out
aroysredn	pronounce
aroysred	pronunciation
aroysreyd	pronunciation
aroysrufn	call out
aroysshikn	send
aroysshlogn	knock out
aroysshvimen	float out
aroystraybn	expel
aroystretn	come out publicly
aroysvaksn	evolve
aroysvayzn	show
aroyszen	realize
aroyszogn	speak
artikl	article
arts	ore
arum	around
arumdreyen (zikh)	rotate oneself
arumforn iber	travel
Arumgeflickt!	Plucked!
arumgeyn	walk around
arumik	surrounding
Arumloifer	Street urchin
arumnem	embrace
arumnemen	embrace
arumnemen zikh	embrace
arumnemik	comprehensive
arumredn	talk over
arunter	down
arunterkrikhn	climb down
arunterkrikhn unter	crawl under
arure	shrew
arye	Arye, aria (opera)
a sach	A lot
a sakh mol	many times
aš	ash
A schwartzen sof	A bad end
A schwartz yor	Bad luck
A shandeh un a charpeh	A shame and a disgrace
ash	ash
ashbeymer	ash tree
ashboym	ash tree
a shepn ton	dip in
a sheynem dank	thank you very much
A sheynem dank!	Thank you very much!
a sheyn ponem!	pretty face!
ashires	wealth
A shittern mogn	Loose bowel movement
a shkandal!	what a scandal!
ashkenaz	Ashkenazi (person)
ashkenazim	Ashkenazi (person)
ashkenazish	Ashkenazic
A shod!	What a pity!
ashtetsl	ashtray
a shteyger	for example
A shtik fleish mit tzvei eigen	A piece of meat with two eyes
A shtik naches	A great joy
a shtokh ton	give someone a dig
a shturkh ton	nudge
A shtyfer mogn	Constipated
asife	assembly
asimilatsie	assimilation
asimilirn (zikh)	assimilate
A sof! A sof!	Let's end it!
asokim	business
astronat	astronaut
astronom	astronomer
astronomie	astronomy
astronoyt	astronaut
atlantish	Atlantic
atletish	athletic
atom	atom
atomish	atomic
a tore ton	nudge
atraktsye	attraction
atsinder	now
atsindert	now (1)
atsind	now
atsomes	dice
A tuches un a halb	person with a very large back
auf dein hent und fiss	a horrible wish on someone (1)
Avade	Of course
avansirn	advance
avanture	adventure
avek	away, off
avekblaybn	absence
avekdreyen	turn (something) away
avekdreyen zikh	turn (oneself) away
avekfirn	walk away
avekforn	leave
avekgeyn	go away
avekkern	turn (something) away
avekleygn	set down
avekloyfn	run away
aveklozn zikh	set out on a trip
aveknemen	take away
avekpatern	waste
avekraysn	tear (onself) away
avekraysn zikh	tear (onself) away
avekshisn	shoot off
avekshteln	put away
avektrogn	carry away
avekvarfn	throw away
aver	smell
aveyre	sin
avle	wrong
avoyde	worship
avoyde zore	idolatry
avrem	Abraham
avrohom	Abraham
ayeder	every
ay	egg
ayen	ayen; 17th letter of alphabet
ayer	your
aykh voyl bakumen	you are welcome
aykh	you
aylenish	hurry
Ayl!	Hurry up!
aylik	oily
ayln	hurry
aynbaysn	bite into
aynbeygn	bend
aynbirgern	naturalize
aynbirgern zikh	naturalize
ayndruk	impression
aynfal	idea
aynfaln	occur to one's mind
aynfirn	introduce
aynflantsn	implant
ayngebildet	conceited
ayngebn	administer
ayngeboyrner	native (of an area)
ayngeboyrn	native
ayngeleybt in zikh	conceited
ayngemakhst	jam
ayngeshparkeyt	stubborness
aynhaltn	hold
Ayn klaynigkeit	sure!
aynkoyfn	shop for
aynkoyf tsenter	shopping mall
aynkuk in..	attention
aynkukn zikh	look
aynladn	invite
aynladung	invitation
aynlernen mit	drill
aynleygn	pledge
aynmakhn	preserve food
aynpakn	pack
aynredn	convince
aynshafn	procure
aynshlefern	put to sleep
aynshlefn	put to sleep
aynshlingen	devour
aynshparn	save
aynshparn zikh	be stubborn
aynshteln	fix
aynshteyn zikh	stand
aynshtiln	hush
ayntaynen mit	plead
ayntsien (zikh)	contract
ayn un tsvontsik	twenty one
aynzapn	absorb
aynzaytik	unilateral
aynzeerish	considerate
aynzen	realize
ayo?	isn't that so?
a yor tsurik	a year ago
ayroplan	airplane
ayter	udder
ayzern	iron
ayz	ice
ayzik	icy
ayzkrem	ice cream
ayznban	railroad
ayzn	iron
ayz yam	Arctic ocean
azan	such a
aza	such a
Az a yor ahf mir	I should have such good luck
azelkher	such
azeyger	o'clock
a zisn peysekh!	Have a sweet Passover!
aznisht	if not
Az och un vai!	Tough luck!
az okh un vey tsu...	poor
azore	courtyard
azoy azoy	so so
Azoy gait es!	That's how it goes!
Azoy gich?	So soon?
azoy meyn ikh	I think so
azoyner	such
Azoy?	really!, Really?
azoy	thus
azsh	all the way
az	when
azyatish	Asian
azye	Asia
baamter	official
baarbetn	till
baarbetung	cultivation
baaynflusn	influence
babe	hag
Babka	Coffee cake style pastry
babke	babka
badanken	thank
badarfn	need
Badchan	Jester
badekns	veiling of a Jewish bride
badekt	covered
baderfenish	need
badkhn	entertainer at a Jewish weddin
badoyeren	regret
badoyerlekh	regrettable
bafaln	attack
bafelkern	populate
bafelkerung	population
bafeln	order
bafel	order
bafestikn	fortify
baflekt	spotted
bafrayen	free
bafrayer	liberator
bafrayndt mit	friendly
bafrayung	liberation
baganvenen	steal
bagazh	luggage
bagazlen	rob
bagegenen	encounter
bagegnish	meeting
bagegn	meet
bager	desire
bagern	desire
bagiltikn	validate
baginen	at dawn
bagleybt	trusted
bagnet	bayonet
bagrenetsung	restriction
bagrentsn	limit
bagrif	concept
bagrisn	welcome (1)
bagrisung	welcome (1)
Bagris Yohan fun mir.	Say Hi to John for me
Bagroben	To bury
bahaltn	hidden
bahaltn zikh	hide (oneself)
bahandlen	treat
bahartst	brave
baheftn	join
baheftung	uniting
baheltenish	concealment
bahershkeyt	composure
bahershn	rule
bahilfik	helpful
bahoftn	joined
Baitsim	Testicles
bakanter	acquaintance
bakant	known
bakenen	introduce
bakenen zikh	meet
baklerik	thoughtful
baklern	consider
baklert	sensible
bakleydn	clothe
baklogn	lament
bakn	bake
baknberd	whiskers
bakoshe	request
bakukn	examine
bakumen	get
bakvem	comfortable
bakvemlekhkeyt	comfort
balagan	mess
balalayke	balalaika
balaykhtn	light up
balbatim	boss (male)
Balbatish	well mannered
balbos	boss (male)
baldik	immediate
bal dover	defendant
baldover	defendant
bald	soon
balebateven	keep house
Balebatim	Persons of high standing, boss (male)
Balebatisheh yiden	Respectable Jews
balebatishkeyt	household
Baleboosteh	Mistress of the house
balebos	boss (male)
baleboste	mistress of the house
bale dover	culprit (female)
baledover	culprit (female)
Balegoola	Truckdriver
balekn zikh	lick one's lips
balem	ball
bale shem	miracle worker
balestikn	molest
baleydikn	insult
baleydikn zikh	be insulted
baleydikung	insult
baleygn	cover
bal guf	fat person
balibt	favorite, beloved
balkn	beam
Balmalocha	An expert
bal+	man of...
bal melokhe	craftsman
baln	bale of hay, interested person
balon	balloon
balones	eagerness
balonim	interested person
baloynen	reward
baloynung	reward
bal pe	orally
balpe	orally
bal shem	miracle worker
bal shem tov	Holy Baal Shem
bal takhles	practical person
bal takhleysim	practical person
Bal Toyreh	Learned man
bal toyve	benefactor
Balt	Sure
bamant	married woman
bamerkn	notice
bamerk	notice
bamerkung	remark
bamidber	Book of Numbers
bamien	strive, Trouble
banan	banana
banayen	renew
banayung	renewal
Bandit	Menace, bandit
band	volume of a book
bandzsho	banjo
banem	conception
banemik	cognitive
banitsn	employ
banits	usage
bankbetl	bunk
banket	banquet
bankrotirn	go bankrupt
bansher	just because
ban statsye	Train station
banugenen zikh...mit	be satisified with
banumen	possessed
banutsn	employ
baputsn	decorate
baputsung	decoration
barak	barrack
baraykhern	enrich
Bareden yenem	To gossip
baredevdik	talkative
barekhenen	consider
barekhtikung	justification
Baren	fornicate
barg	Mountain
bargrukn	ridge
barikhes	extensively
barikht	report
barimen zikh	boast
barimt	famous
barirn	touch upon
barir	touch
barmitsve	Bar Mitzvah
baron	baron
barot	care
barsht	brush
barshtn	brush
baruekhts	tranquilizer
baruikn	quiet
bashaf	Creation
bashafn	create
bashaymperlekh	evident
bashaynen	beautify
bashedikn	damage
bashefenish	creature
bashefer	Creator
Bashert	predestined, destined
Bashert zein	To be destined
basheyden	modest
basheydnkeyt	modesty
bashiremen	shield
bashitsn	protect
bashlosn	decide
bashlus	decision
bashraybn	describe
bashraybung	description
bashtand	composition
bashtandteyl	component
bashteln	order (goods)
bashtetikn	certify
bashteyn	consent
bashteyteyl	component
bashtimen	designate
bashtimt	designated
bashtimung	appointment
bashtrofn	punish
bashuldikn	accuse
bashuldikung	accusation
bashvenkn	rinse
bas malke	princess
basmalke	princess
Bas yekhide	A female only child
Batampte	delicious
batamt	delicious
batapn	touch
batayt	meaning
bataytn	mean
baterye	battery
batey	Batim
bateyliker	participant
bateylikn zikh	participate
bateylikung	participation
batim	Batim
Batlan	Someone without a trade
batonen	sound
batrakhtn	consider
batrakhtung	consideration
batribt	sad
batsetlen	write'n a small piece of paper
batseykhn	label
batsien zikh	relate to
batsirn	adorn
batsiung	relation
batsoln	pay
baumruikn	disquiet
bavakhn	guard
bavaksn	overgrown
bavaybt	married man
bavayzn	exhibit
bavayzn zikh	appear
bavayz	showing
bavebt	woven
bavegn	move
bavegn zikh	exercise
bavegung	movement
baveldert	forested
bavilikn	accord
bavilikung	grant
bavl	cotton
bavorfn	ply with
bavundern	admire
bavunderung	admiration
bavustzayn	consciousness
baybak	marmot
bay	beside
bay dem	while
baydl	small covered wagon
bayhilfik	helpful
baykher	tummy
baykhl	small belly
baykumen	overcome
baylage	supplement
baym	while
baynakht	at night
bayshpil	example
baysik	biting
baysn	bite
Baysn zikh di finger vos	Regret strongly
baytl	purse
baytn	change
baytn zikh bay	take turns at
baytog	by day
baytsh	whip
bayzayn	presence
baze	base
bazetsn zikh	settle
bazingen	laud in song
bazirn	base
bazorgn	attend to
bazorgt	anxious
bazukher	visitor
bazukhn	visit
bazunder	separate
bazundersh	unusually
bazunders	several
bb'	volumes
bdeye hobn	intend
beben	mumble
bebl	bean
Becher	Wine goblet
beder	bathhouse
bederekh klal	generally
bederekh moshl	figuratively
beelef	versus
beemes	really
befeyresh	explicitly
befrat	particularly
be generous	be generous
begneyve	stealthily
Behaimeh	Animal
behole	confusion
beim	if
Bei mir hust du gepoylt	You've gotten your way with me
bekeray	bakery
beker	baker
bekher	wine glass
bekheyn	therefore
bekies	proficiency
bekitser	briefly
bekivn	on purpose
bekl	cheek (diminutive form)
bekovedik	honorable
bekoyekh	strongly
belakhesh	quietly
beletristik	fiction
beletristish	fictional
belgiye	Belgium
belorusye	Belorussia
be me	blah
bemeshekh...fun	during
bemeyle	therefore
ben bayes	member of the household
bench	pray
bendl	ribbon
bendor	contemporary
benegeye	concerning
benemones	honestly
benimesdik	urbane
benimes	politely
benkenish	longing
Benken	To yearn for, miss
benkl	chair
Benkshaft	Homesickness, longing
ben meylekh	prince
ben mlokhim	prince
ben odem	man
ben	son of
Bentshen lecht	Recite prayer over lit candles
bentshlikht	candles
bentshn	bless
Bentsh	To bless
ben yisroel	Israelite
benyokhed	only son
Ben yokhid	A male only child
benzin	gasoline
ber	bear
bereze	birch tree
bergl	Hill
berkh	approximately
berkshir	Berkshire hills
Beryeh	Efficient
berye	skillful person
besakhakl	all told
besalmen	cemetery
besarabia	Bessarabia
beser veln	prefer
beshas	while
besmedresh	prayer house
Bes medresh	Synagogue
besodik	secret
besod	secretly
besoylem	cemetery
bestye	beast
betgevant	bedding
betl	berth
betlbroyt	handouts
betlen	beg
betler	beggar
betn	ask
betn got	pray
betokhn	faith
betoyres	by way of
betsiber	collectively
beyde	both
beyg	bend
beygfal	case (in grammar)
beygl	bagel
beygn (zikh)	bend
beymer	tree
beyn	bone
beyne lebeyne	meanwhile
beyner	bone
beynhashmoshes	twilight
beysakneses	synagogue
beysakvores	cemetary (Jewish)
beysamigdesh	the Temple in Jerusalem
beys	beys; 2nd letter of alphabet, house, while
beysbol	baseball
beytse	egg
beytsim	egg
beyz	bad
beyzer	indignation
beyzer kholem	nightmare
beyzern zikh	be angry with
bezdn	rabbinical court
beze haloshn	follow
bezem	broom
bez	lilac
bezn	rabbinical court
bgile rosh	head uncovered
bgneyve	secretly
bgvald	by force
bialostok	Bialostok
Bialy	the Polish city of Bialystock, bialy
biber	beaver
biblyotekerin	librarian (female)
biblyoteker	librarian (male)
biblyotek	library
bidne	poor
bif	Beef
bifresye	openly
bikher	book
bikherdik	bookish
bikher revizie	audit
bikher revizior	auditor
bikher vinkl	book end
bikhl	book (small)
bikl	marble
biksav	written
Bikur cholem	Visiting the sick
bilbl	false accusation
bilbul	false accusation
bilderish	vivid
bild	picture
bild sheyn	gorgeous
bildung	education
bilet	Ticket
bilik	cheap
Billik	inexpensive
bilyon	billion
bime	bima
bimkem	substitute
bimtsies	available
bindn	tie
bindrung	link
bine	stage
bintl	bundle
binyen	building
binyomen	Benjamin
biografye	biography
biolog	biologist
biologish	biological
biologye	biology
birger	citizen
birgerkrig	civil war
birgerlekh	civil
birgermayster	mayor
bisel	bit
biskup	bishop
bisl	bit
bislekhvayz	gradually
Bist meshugeh?	Are you crazy?
Biteh	Please
Bite	Please
biter	dire
bitl	contempt
bit	tub
biyr	Beer
biz aher	up to now
biz a hor	exactly
bizantinesh	byzantine
Biz shpeter!	See you later!
biz tsen a zeyger	until 10 o'clock
bkhinem	free
bkhipozn	hastily
bkhlal	in general
bkies	proficiency
bklal	in general
bkoved	honorably
bksav	written
blas	pale
blat	newspaper
blaybl	tab
blaybn	remain
blaybn shteyn	stop
Blayb on!	Hold on please!
blayer	pencil
blay	lead (metal)
blekhl	tin badge
blekhn	made of sheet metal
blekh	tin plate
bleter	newspaper
bletl	leaflet
bleykh	pale
blezl	bubble
bliask	glare
blien	bloom
bli	in full bloom, bloom
blik	look
blind	blind
blinde kishke	appendix (anatomical)
blindkeyt	blindness
blitsbriv	email
blitsbrivl	email
blits	flash
blitspost	email
blitsshlesl	zipper
blo	blue
blog	blog
blogirn	blog
blokova	blokova
blond	blond
Blondjen	To wander
blondzhen	stray
blote	mud
blotik	sloppy
bloy	blue
bloyz	only
bloz	blow
blozn	blow
blozn fun zikh	put on airs
blozn shoyfer	blow the shofar
blum	flower
blutik	bloody
bluze	blouse
bney odem	man
Boarderkeh	A female boarder
bob	bean
Bobe	Grandmother
bobe mayse	tall story
bobeshi	granny
Boch	A punch
bod	bathhouse
bodhitl	bathing cap
bodkostum	bathing suit
bodn zikh	bathe (oneself)
Bohmer	Bum
Bohmerkeh	Bum (fem.)
bokher	young man
boks	boxing
bokser	boxer
boksn zikh	box (fight)
bombe	bomb
bonem	sons
Boorvisser fiss	Barefoot
bopkes	something extremely trivial
bord	beard, chin
Borekes	Pastries with cheese inside
borekh	blessed
Borekh habo!	Welcome!
borekh hanimtse	"reply to ""Welcome!"""
borkhabe	welcome!
Borsht	Beet soup
borukh habo!	"reply to ""Welcome!"""
borves	barefoot
Borviss	Barefoot
boser kosher	kosher meat
bote medroshim	prayer house
Botvenye borsht	Borsht made from beet for poor
bovl	junk
boyan	hoodlum
boybrekh	debris
Boychik	Young boy
boyd	covered wagon
boydem	attic
boydem shtub	loft
boyen	build
boygn	sheet
Boykh	abdomen, tummy
boylet	outstanding
boyml	oil, oil (for eating)
boym	tree
boyre	the Creator
boy	structure
boytn	shake (liquid)
boytshikl	sweet young boy
boytshik	young boy
boyvapne	mortar
brakirn	reject
braselet	bracelet
bratslav	Bratslav
brave	bold
bravo!	good for you!
breeder	brother
Breeye	Creature
breg	shore
breg taykh	riverside
Breire	choice
brekhn	break
brekl	scrap
brem	eyebrow
bren	fire
brengen	bring
brengt mir dem cheshbn; bite	Please bring the bill
breslau	Breslau
bretl	small board
breyre	choice
breyshesdik	primeval
breyshes	genesis
breythartsikeyt	generosity
breythartsik	generous
breytl	small bread
breyt	wide
bridershaft	brotherhood
bridke	ugly
brie	creature
brikl	bridge (of a ship)
briln	glasses
brilyant	diamond
brinze	sheep cheese
Bris	Circumcision, circumcision ceremony
brisl	Brussels
Bristen	Breasts
briv	letter (mail)
brodvey	Broadway
Broitgeber	Head of family
brokh	crack
brokhe	blessing
Bronfen	Whiskey
bronfn	whiskey
bronks	Bronks
bronz	bronze
brosh	at the head of
brotn	fry
broygez	friction
Broygis	Not on speaking terms
broyn	brown
broyt	Bread
broytnitse	breadbox
broyzn	sparkle
brudershaft	brotherhood
brukhim haboim	welcome!
Brukhim haboim!	Welcome! (pl)
brukhteyl	fraction
brukhtsol	fraction
brumen	hum
brumlen	rumble
brunem	well (for water)
brunet	brunette
brustkastn	thorax
bshas mayse	meanwhile
bshefe	abundant
bsholem	safely
bshutfesdik	joint
bshutfes	jointly
bsimedik	spicy
bsoykhem	including
B'suleh	Virgin
bsule	maiden
bsure	message
btshuve	in answer to
btsiber	collectively
Bubbee	Friendly term for who you like
Bubbeh	Grandmother
Bubbe maisse	Grandmother's tale
bubbie	grandmother
bubby	grandmother
bube	bubby
bubele	darling!
bubkes	something extremely trivial
budapesht	Budapest
buh	book
bukh	book
bulbe	potato
bulgar	bulgar
bulke	baked roll
Bulvan	Man built like an ox
bulvar	boulevard
bund	Jewish Labor Bund, tie
Bupkis	Nothing
burik	beet
burtshen	grumble
burzshuaz	bourgeois
burzshuazie	bourgeoise
bushe	shame
bushl	stork
Butchke	chat
byerushe	inheritence
byuralist	office worker
byuro	office
Chaider	Religious School
Chai	Hebrew word for LIFE
Chaimyankel kooternooz	The perennial cuckold
Chaim Yonkel	any Tom
Chaleria	Evil woman
chaleshen	Faint
Challa	"Ceremonial ""egg"" bread"
Chaloshes	Nausea
Chamoole	donkey
Chamoyer du ainer!	You blockhead!
Chanukah	Festival of Lights
Chap a gang!	Beat it!
Chap ein a meesa meshina!	May you suffer an ugly fate!
Chap nit!	Not so fast!
Chaptsem	Catch him!
Chassene machen	To plan and execute a wedding
Chassene	Wedding
Chavver	Friend
Chaye	Animal
Chazen	cantor
Chazenteh	Wife of chazen
chazer fleysh	Pork
Chazzer	A pig
Chazzershtal	Pigpen
Chei kuck	Nothing
Chev 'r' mann	Buddy
chinezish	Chinese
Chmalyeh!	punch
Chochem	A wise man
Chochmeh	Wisdom
Choleryeh	plague
Choshever mentsh	Man of worth and dignity
Chosid	Rabid fan
Chossen	Bridegroom
Choyzik machen	Make fun of
Chrain	Horseradish
Chropen	Snore
Chub Rachmones	Have pity
Chug	Activity group
Chupah	Canopy under marriage ceremony
chutzpah	great impudence
Chutzpeh	Brazenness
Chutzpenik	Impudent fellow
Chvalye	Ocean wave
Columbus's medina	It's not what it's cracked up
dach	roof
dafke	necessarily
daf yomi	Daf Yomi
dagesh	the diacritical point
dakh	roof
dakhtn zikh	seem
daled	daled; 4th letter of alphabet
dales	poverty
danent	from here
dankbarkeyt	gratitude
dankbar	thankful
Danken Got!	Thank God!
danken	thank
dankshaft	gratitude
dank	thanks
Darf min gehn in kolledj?	For this I went to college?
darfn	must
darshenen	preach
darshtn	be thirsty
dar	thin
date	date (calendar)
Davenen	Pray
davke	necessarily
davnen	pray
dayge	worry
dayn	your
daytlekh	plain
daytsh	German, German (person), Germanic
daytshish	German
daytshland	Germany
daytshmerish	too Germanic
definitsie	definition
dehayne	namely
Deigeh nisht!	Don't worry! (1)
dekher	roof
dekhn	gasp
dekn	cover
dektukh	bridal veil
delikat	delicate
demolt	at that time
dem ruekhs advokat	devil's advocate
denker	thinker
denkmol	monument
dentsmol	then
derbaremdik	merciful
derbaremen zikh (oyf)	take pity
derbay	hereby
derbayik	nearby
derefenung	opening
derekh	way
derfar	therefore
derfarung	experience
derfer	village
derfiln	sense
derfin	about it
derfl	hamlet
derfreyn	please someone
derfrishn	refresh
derfun	from this
dergantsn	complete
dergeyn	ripen
dergeyn zikh tsu	find one's way to
dergreykh	accomplishment
dergreykhn	accomplish
derhaltn	maintain
derhargenen	kill (1)
derhargen	kill
derhayntikn	update
derhern	hear
der hoypt	especially
deriber	therefore
der iker	chiefly
derikersht	chiefly
derinen	within
derin	herein
derkegn	against it
derkenen	recognize
derkherets	respect
derklern	explain
derklerung	explanation
derkutshen	annoy
derlangen	hand (out)
derlebn	live to see, To live to see
derleydikn	take care of
derleygn	lose money in a business
derleyzn	save
derloybn	permit
derlozn	allow
dermanen	mention
dermanen zikh	remember
dermit	thereby
dermonen	mention
dermonen zikh	remember
dermon	reminder
dermonung	mention
dernentern	bring closer
dernern	nourish
dernerung	nourishment
derniderikn	humiliate
dernokh	afterwards
dernokhdem	afterwards
deroyf	hereupon
Der oyg	Eye
Der oysdruk	Expression
dershatsn	appreciate
dershaynen	be published
dershaynung	phenomenon
dershisn	shoot to death
dershlogn	depressed
dershlogn zikh tsu	find one's way to
dershpirn	feel
dershrokn far	frightened
der shteyger lebn	way of life
dershtikn	choke
dershtikt vern	suffocate
Dershtikt zolstu veren!	You should choke on it!
dershtoynen	amaze
Der tate oysn oyg	Just like his father
der	the
dertrunkn vern	drown
dertseyln	tell
dertseylung	tale
dertseylzats	declarative sentence
dertsiung	upbringing
dertsoln	pay up
dertsu	moreover
Der universitet	University
derunter	under it
dervaksene	adult (female)
dervaksener	adult (male)
dervaksn	adult
dervaksnshaft	adulthood
dervaksung	adolescense
dervayle	meanwhile
dervayl	meanwhile
dervaytern zikh	withdraw
dervaytert	withdrawn
dervayzn	prove
dervayz	proof
dervegn	about it
derveyln	elect
derviderdik	offensive
dervider	distasteful
dervishn	catch
dervisn zikh	find out
derzen	spot
derzogn	say
Der zokn	Old man
desert	Dessert
deshifrirn	decipher
dest glaykhn	likewise
detsember	December
deye	authority
dialekt	dialect
dialektish	dialectical
dialog	dialog
dibek	dibbuk; an evil soul of dead
dibraye	commandments
dibukim	dibbuk; an evil soul of dead
Die goldene medina	the golden country
di emese mayse	cancer
Die untershte sheereh	the bottom line
di fareynikte shtatn	United States
dikdek	Hebrew grammar
dik	fat
Di khemye	Chemistry
dikhterish	poetic
dikhter	poet
dikh	you
diklekh	chubby
dil	floor
diment	diamond
Dine Essen teg	Eat days
dinen	worship
diner	servant
Dingen	Bargain
dinstik	Tuesday
dinstog	Tuesday
dinye	pumpkin
dire	apartment
diregelt	rent
dirigent	conductor
dirigirn	control
dir	you
Dis fayntin shneg	It's starting to snow
Dis fayntin zoraiganin	It's starting to rain
Di skeyne	Old woman
Di Skeynes	Old women
Di skeynim	Old men
disk	record
diskusye	discussion
di	the
divan	sofa
divrey	words of
di yene mayse	cancer
dizayn	design
dliben	pick
dloyben di noz	pick one's nose
dloyben	pick
dluben	pick
do arumert	this way
Do	Here
Do!	Here you go!
dokh	yet
dokter	doctor
doktor	doctor
doktoyrim	doctor
dokument	document
dolar	dollar
donershtik	Thursday, on Thursday
dorem	south
dorfish	rural
dorf	village
dorshtik	thirsty
dorsht	thirst
dortik	local
dortn	there
dort	there
dos...dos	now...now
dos doziker	these
Dos gefelt mir	This pleases me
dos gehert nisht tsu dir!	It's not your job to do that!
Dos hartz hot mir gezogt	My heart told me
Dos iz alts	That's all
Dos iz gut!	That's good!
dos pintele...	essence of...
Dos	This, the
Dos zelbeh	The same
dov	Dov (name)
dover	object
doyern	last
doyme	similar
doziker	this
Draikop	Scatterbrain
Drai mir nit kain kop!	Don't bother me!
Drai zich!	Keep moving!
dramaturg	playwright
dramaturgye	playwrighting
drayek	triangle
draye	three o'clock
drayfus	tripod
drayling	triplets
draysikst	thirtieth
draysik	thirty
dray	three
drayts	bold
draytskeyt	boldness
draytsn	thirteen
draytsnt	thirteenth
dray un a fertl	3:15
dray un fiftsn minut	3:15
dreck	shit
Dreidal	Spinning top used in a game
Drek auf dem teller	Mean spirited
drek	dirt, Human dung
Drek mit Leber	Absolutely nothing
dremlen	nap
dreml	nap
drerd	earth
dreydlen	turn
dreydl	spinning top
dreyen a spodik	bother
dreyen	twist
dreyer	evavise person
dreykop	swindler
drey	turn
drikn	press
dringen	claim
dritl	third
dritns	thirdly
drit	third
drobne	fine
droen	menace
drokhim	way
droshe	speech
drot	wire
droysndik	outside
droysn	outside
Druchus	The sticks
drukeray	printing shop
druker	printer
druk	pressure
Du bist zeyer khaverish!	You're very kind!
duel	duel
duet	duet
Du fangst shoyn on?	Are you starting up again?
dugme	example
dukh	breath
dumen	brood
Dumkop	Dumbbell
dunerdik	thunderous
dunern	thunder
duner	thunder
duplikat	duplicate
durkh	by way of
durkh danen	this way
durkhdringen	penetrate
durkhfal	defeat
Durkhfall	A flop or failure
durkhfirn	carry out
durkhfliik	flying past
durkhforn	pass through
durkhgelekhert	full of holes
durkhgetribn	cunning
durkhgeyer	traveler
durkhgeyn	go through
durkhkukn	look through
durkhlaykhtn	shine through
durkhloyfn	pass by
durkhn	through the
durkhoys	absolutely
durkhredn zikh mit	have a talk with
durkhshlak	colander
durkhshnitlekh	average
durkh un durkh	through and through
durkh vanet	which way?
durkhzikhtik	transparent
durkshnit	average
durkzikh	search
dushne	stuffy
dvar	thing
dvorem	thing
dvorets	palace
dvorim	thing
Dybbuk	Soul condemned to wander
dzshet	jet
dzshez	Jazz
dzshiraf	giraffe
dzshukhe	insect
Ech	A groan
Ech mir	Humorous
efekt	effect
efenen	open
efentlekh	publicly
efntlekh	public
efrem	Efrem
efsher	perhaps, could be
egoistish	selfish
egoizm	selfishness
Ei! Ei!	Oh!
Eingeshpahrt	Stubborn
Eingetunken	dunked
Einhoreh	The evil eye
Eizel	dope
ek	corner, tail
ekhod	Oneness of God
ekht	genuine
ekldik	disgusting
ekl	disgust
ekran	screen
ekshnuskdik	persistent
ektrem	extreme
Ek velt	End of the world
ekzemplar	specimen
ekzistents	existence
ekzistirn	exist
elegant	elegant
elehey	as if
elf draysik	11:30
elf	eleven
eli	Eli
elnboygn	elbow
elnt	lonely
elter	age
eltern	parents
elyezer	Eliezer
elyohu hanovi	Elijah the prophet
Emanuel	Emanuel
emer	pail
emesdik	truly
emes	truth, correct, The truth
emetser	someone
Emitzer	Someone
emotsye	emotion
endern	change
enderung	change
endikn	finish something
endung	ending grammar
English	English
eng	tight
enlekh	alike
enlekhkeyt	similarity
Enschultig meir	Well excuuuuuuse ME!
entfer	answer
entfern	answer
Entoisht	Disappointed
entsikolpedye	encyclopedia
epes	something
epizod	episode
epl	apple
eplboym	apple tree
eplzaft	apple cider
Eppes	Something
Er bolbet narishkeiten	He talks nonsense
erd	earth
erekh	approximately
Eretz Yisroel	Land of Israel
erev	on the eve of
Er frest vi a ferd	He eats like a horse
erger	worse
ergets	somewhere
Er hot a makeh	He has nothing at all
Er hot nit zorg	He hasn't got a worry
Er iz shoyn du; der nudnik!	The nuisance is here already!
erlekh	honest
Er macht a tel fun dem	He ruins it
er mentsh	one of us
ernhaftik	honorable
ernst	earnest
ersht	first
er taig nit	He's no good
Er toig nit	He's no good
ertsyisroel	Palestine
Er zitst oyf shpilkes	He's restless
Es brent mir ahfen hartz	I have a heartburn
Es frayt mikh dikh tsu kenen.	Nice to meet you!
Es gait nit!	It doesn't work
Es geyt gut; a dank!	I'm fine; thanks!
Es gezunterheyt!	Enjoy! (For meals...)
Es iz a shandeh far di kinder!	It's a shame for the children!
es iz a svore az..	It is likely that..
es iz faran	there is
Es iz nit dayn gesheft	It's none of your business
Es iz tsen a zeyger	It's 10 o'clock
Es iz (tsu) shpet	It is (too) late
Es iz zibene un traytsik inem	07:30pm
Es ken gemolt zein	it is conceivable
es ken zayn	it's possible
Es macht mir nit oys	It doesn't matter to me
esn	food, eat
esnvarg	food
Es past nit	It is not becoming
esreg	citron
esroygim	citron
Ess	Eat
Essen mitik	Eating midday
Ess gezunterhait	Eat in good health
Ess vie ein foygl	Eat like a bird
ester	Ester
Est gezunterhayt!	Bon appetit!
estraykh	Austria
estraykhish	Austrian
estsimer	dining room
Es tut mir a groisseh hanoeh!	It gives me great pleasure
Es tut mir bahng	I'm sorry
Es tut mir vai	It hurts me
Es vet gornit helfen!	Nothing will help!!
es volt geven a svore az	It wouldn't be a bad idea to
etik	ethics
etimologye	etymology
etish	ethical
etlekh	some
etsem	dice
etvos	little
evakuirn	evacuate
evangelyum	gospel
everybody can go to hell!	ch'ob ich alles in dread
evolutsye	evolution
exchange	exchange
eybersht	upstairs
eybik	eternal
eybikeyt	eternity
eyde	community
eyder	before
eydl	genteel
eyernekhtn	day before yesterday
eyfele	baby
eygene	relatives
eygener	relative
eygl	eyelet
eygnartik	peculiar to
eygn	same
eylbert	olive
eyn bilet kayn...;bite	One ticket to...; please
eyner dem andern	each other
eynheyt	unity
eyniklekh	grandchild
eynikl	granddaughter
eyn mol far ale mol	once and for all
eyn mol	once
eyn	one (number)
eyns finf un fertsik	1:45
eyn sof	infinity
eyns	one, one (when counting numbers)
eyntsik	only
eyntsol	singular
eyrope	Europe
eyropeyer	European man
eyropeyerin	European woman
eyropeyish	European
eysek	business
eysev	Esau
eytse	advice
eyver	limb of a body
eyvrim	limb of a body
eyzl	donkey, ass
ezras	courtyard of...
fabrik	factory
Fahrshvindn	Disappeared
Faigelah	Bird
fakh	trade
faksmashin	fax machine
fakt	fact
faktish	actual
faktor	factor
falb	fold
fal	case
falk	hawk
faln	fall
falsh	wrong
familye	family name
fanfate	nasal
fan	frying pan
fang	catch
fangen	catch
fantastish	fantastic
fantazye	fantasy
farakhtogn	a week ago
faran	available
far and dem	in front of
faranen	available
farantvortlekh	responsible
far a yor	last year
farayor	last year
farband	association
farbay	gone
farbaysn	dessert
farbayter	replacement
farbaytn	replace
farbaytn zikh mit	trade
farb	color
farbenkt	nostalgic
farbesern	improve something
farbesern zikh	improve onself
farbeserung	improvement
farbetn	invite
farbetung	invitation
farbindn	bind
farbindn zikh mit	join
farbindung	connection
farbisn	stubborn
Farbissener	Embittered
farblaybn	remain
farblift	stunned
Farblondzhet	bewildered
farblondzshen	lose one's way
farblondzshet	lost
Farblujet	Bending your ear
farblutikt	bloody
farborgn	hidden
Farbrecher	conman
farbrekher	criminal
farbrekherish	criminal
farbrekhik	criminal
farbrekhn	crime
farbrengen	spend
farbreytern	broaden
farbundn	connected
fardamt	denounced
Fardeiget	Distressed
fardekhtik	suspicious
Fardinen a mitzveh	Earn a blessing
fardingen	rent out
Fardrai zich dem kop!	Go drive yourself crazy!
fardreyt	distorted
Fardross	disappointment
fareltert	out of date
farenderung	change
far eyn gang	at the same time
fareynikn	unite
fareynikte natsies	United Nations
fareynikt	united
fareynikung	unification
farfaln	lost
farflikhtet	obligated
Farfolen	Lost
far	for something, in front of
Farfoylt	Mildewed
Farfroyren	Frozen
fargangenheyt	past
fargangen	past
fargeln	make yellow
fargenign	joy
fargesn	forget
Fargessen	Forgot
fargeyn	pass away
farginen	wish well
farglaykhung	simile
fargvaldikn	rape
fargvaldikung	rape
farhalt	delay
farhaltn	delay
farhaltn zikh	be delayed
farheylikn	sanctify
farheylikt	sanctified
farheyrat	married
farhitndik	preventive
farhitn	prevent
farhungert	famished
farinteresirt	interested
Farkakte	shitty
farkakt	lousy
farkamen zikh	comb one's hair
farkerlomp	traffic light
farkert	on the contrary
farker	traffic
farkhapn	capture
farkhapndik	fascinating
farkirtsn	abbreviate
farkirtsung	abbreviation
Farklempt fis	Not being able to walk right
Farklempt	Too emotional to talk
farklemt	depressed
Far Knaft	Engaged
farkneplen	button something
farkoyferin	salesperson (female)
farkoyfer	vendor
farkoyfn	sell
farkoyf	sale (of goods)
farkrikhn	crawl into
farlag	publisher
farlang	desire
farlangen	desire
farleygn	found
farlirn	lose something
farloyrn geyn	be lost
farloyrn	lost
farlozn	deserted
farlozn zikh	grow
Farmach dos moyl	Shut up!
farmacht	Closed
Farmatert	Tired
farmer	farmer
farmest	competition
farmishn	mix
farmisht	mixed up, Befuddled
farmoger	owner
farmogn	own
farmog	property
Farmutshet	Worn out
farnakht	dusk
farnemen	take up
farn	in front of
farpeynikn	torture
Farpitzed	To get all dressed up
farplontern	snare
farpoylisht	Polishized
farreytlen zikh	blush
farrikhtn	fix
Farschimmelt	Moldy
farshafn	procure
farsharn	rub
farshartsn	tuck up
farshemen	embarras
farshemen zikh	become embarrased
farsheydene	miscelleneous
farsheyden	various
farsheydnkeyt	variety
farshimlt	moldy
Farshlepteh krenk	Fruitless
farshmayet	busy
Farshmeieter	Highly excitable person
farshmirt	stained
Farshnickert	Drunk
Farshnoshket	drunk
farsholtn	accursed
farshpreyt	widespread
farshraybn	write down
farshraybn zikh	register oneself
farshribn	written down
Farshtaist?	You understand?
farshtanen vern	be understood
farshtayfn	tighten
farshteln	obstruct
farshtendenish	understanding
farshtendik	intelligible
farshtendikung	understanding
farshtendlekh	intelligible
farshtendlekhkeyt	intelligibility
farshtern	spoil
farshteynern	petrified (wood)
farshteynert	petrified (wood)
farshteyn	understand
farshteyt zikh	of course
farshtopn	clog up
Farshtopt	Stuffed
farshtunken	stinky, Smells bad
farshvaygn	keep quiet
farshvern	conjure
farshvern zikh	conspire
farshvign	kept quiet
Farshvitst	sweaty
farshvundn vern	disappear
fartatshish	sloppy
fartekh	apron
Fartik	complete
fartog	dawn
farton	absorbed
fartrakht	thoughtful
fartreter	representative
fartretn	represent
fartriknt	arid
fartrinken	spend money
fartsam	block
fartsamung	fence
far tsaytn	of old
fartsen	fart
fartseykhenen	note
fartshepen	hook
fartshepen zikh (ikh)	stumble on
fartsiter	thrill
fartsitert	trembling
fartsoygn	endearing
fartsukn	devour
fartsveyflt	desperate
farvalter	manager
farvandlen	convert
farvandlung	conversion
farvaylerish	entertaining
farvayln	entertain
farvaylung	pastime
farvebt	woven
farver	prohibition
farvetn zikh	wager
farviklenish	entanglement
farvisht	fuzzy
far vos nisht	why not
farvos nisht	why not
Farvos nisht?	Why not?
far vos	why
farvos	why
faryidishn	make more Jewish
faryorik	last year's
farzamlung	meeting
farzeenish	monster
Far zikher	For sure
farzorgn	welfare (support)
farzorgopteyl	welfare department
farzshavert	rusty
farzukhn	taste
fastn	fast
fatal	fatal
fatsheyle	shawl
Fayeke	Capable
Fayeker	Capable
fayer	fire
fayerlekh	solemn
fayern	celebrate
fayfl	whistle (instrument)
fayfn	whistle
fayf	whistle
fayg	fig
fayl	arrow, file (tool)
fayln	file
fayn	fine
faynt hobn	hate
februar	February
fedem	diminutive (grammar)
federesht	forward
feder	pen
feferdik	peppery
fefer	Pepper
Feh!	It's no good
Feinkochen	Omelet
Feinshmeker	Hi falutin
feld	field
feldz	rock, cliff
feler	mistake
feln	absence
felndik	missing
felsher	forger
Fendel	pan
fendl	penant
fentster	window
ferdbin	hornet (insect)
ferd	horse
ferdish	horsy
ferdl	pony
ferme	ferdl
fershke	peach
fertsik	forty
fertsn	fourteen
feter	uncle
fet	fat, obese
Fetter	Uncle
fey	fey; 19th letter of alphabet
feygele	little bird
feygl	bird
feyik	able
feyikeyt	ability
fe	yuck!
fidlen	fiddle
fidler	fiddler
fidl	fiddle
fiftsik	fifty
fiftsn	fifteen
fiftsn tsu tsvey	1:45
figur	figure
fiktiv	fictional
filfarbik	colorful
fil	many
film	movie
filn	fill
filn zikh	feel (in onself)
filologish	philological
filolog	philologist
filologye	philology
filosofish	philosophical
filosof	philosopher
filosofye	philosophy
filts	felt (material)
finantsirn	finance
finantsyel	financial
finef	five
finfek	pentagon
finfele	nickel
finf	five
finft	fifth
fingerdruk	fingerprint
finger	finger, toe
fingerhut	thimble
fingerl	ring on a finger
fingern	finger
fingershikh	thong
fingershukh	thong
finkldik	sparkling
finklen	sparkle
finkl	sparkle
Finster un glitshik	Miserable
fintster	sinister
fiol	vial
firekhts	practice
firer	leader
firershaft	leadership
fir	four, practice
firhang	curtain
firkumen	take place
firleygn	propose
firleyg	proposal
firme	firm
firndik	leading
firn	lead
firn zikh	behave
firsht	duke
firshtnshaft	duchy
firung	conduct
Fisfinger	Toes
fisher	fisherman
fish	Fish
fis	leg
fisl	furniture leg
Fisslach	duck's feet
fistashke	peanut
fizik	physics
fizish	physcial (not mental)
flakern	blaze
flaks	flax
flam	flame
flantsn	plant
flash	bottle
flaterl	butterfly
flatern	flutter
flaysik	industrious
fledermoyz	bat
fleg	used to...
flek	spot
fleyshik	meaty
fleysh	Meat, flesh
fleyt	flute
Fliegel	Fowl's wing
flier	flier
fli	flight
flig	fly
fligl	wing
fligplats	Airport
fliik	flying
flikht	duty
flisikeyt	fluid
flisik	liquid
flisn	flow
flokn	club
floy	flea
floym	plum, prune
f''n	United Nations
Focha	Fan
fodem	diminutive (grammar)
fodern	demand
Foigel	Smart guy
Foiler	Lazy man
Foilishtik	Foolishness
fokher	hand fan
Folg mikh a gang!	Quite a distance
Folg mikh!	Obey me!
folgn	obey
folk	people, people
folkshprakh	vernacular
folks	popular
folksshul	public school
folksvertl	folksaying
fonetik	phonetics
fonetish	phonetic
fonfen	speak with a twang, Speak through the nose
fon	flag
fontan	fountain
fooey	Designates disbelief
forem	shape
forer	traveler
forgefil	premonition
For gezunterhait!	Bon voyage!
forik	previous
forkumen	take place
forleygn	propose
forleyg	proposal
forn	drive
forn zikh	go
foroys	forward
for	ride
forsherish	scholarly
forsher	scholar
forshn	study
Forshpeiz	Appetizer
forshpil	prelude
forshteln	present
forshteln zikh	imagine
forshtelung	play
forshteyer	representative
forshtot	suburb
forshung	research
forts	fart
Fortz	Fart
Fortz n' zovver	A foul
forverts	forward
Forzikhtig!	Careful!
forzits	chairmanship
forzitser	chairman
fostemkes	ways
foter	father
foygl	bird
foyglen	bird
foyl	lazy
foyln	rot
foyln zikh	be lazy
Frageh	Question (1)
frage	question
Frailech	Happy
frankraykh	France
frantsoyzish	French
frask	slap
Frassk in pisk	Slap in the face
frayheyt	freedom
Fraylekhn Krismes	Merry Christmas
fraylin	Miss
fraynd	friend
frayndlekh	friendly
fraytik	Friday
fraze	phrase
fregn	ask
fregt mikh bekheyrem	I haven't the slightest idea
Freint	Friend
fremder	stranger
fremd	strange
freser	glutton
Fress	Eat....pig out
Fressen	devour
Fressing	Gourmandizing
freyd	joy
freylekh	cheerful
Freylekhe nitl!	Merry Christmas!
fridzshider	refrigerator
friik	early
friling	Spring
frimer	Pious
frimorgn	morning
frish	fresh
frishtik	Breakfast
front	front
frost	frost
frostik	frosty
froy	Mrs., woman
frucht	Fruit
frukht	fruit
frumkayt	piety
frum	pious
fuks	fox
ful mit	full of
fulshtendik	complete
funanderlozn zikh	dissolve
fundatsye	foundation (fund)
fun demolt on	ever since
fun dest halbn	on this account
fundestvegn	however
funem	from the
fun eyn teyg geknotn	birds of a feather
Funfeh	Speaker's fluff
fun	from
funk	spark
fun tsayt tsu tsayt	now and then
fun vanent	from where
Fun vanent kumstu?	Where are you from?
fun vanet	from where?
fun zint	ever since
fusbol	soccer
fus	foot
fusnogel	toenail
futs	futz
Gai avek!	Go away
Gai feifen ahfen yam!	Go peddle your fish elsewhere!
Gai gezunterhait!	Go in good health
Gai in drerd arein!	Go to hell!
Gai kaken oifen yam!	Get lost
Gai mit dein kop in drerd	Go with your head'n the ground
Gai platz!	Go split your guts!
Gai shoyn; gai	Scram!
Gai strasheh di vantzen	You don't frighten me!
Gait es nit!	It doesn't work!
Gait; gait!	Come now!
Gai tren zich	Go **** yourself
Galitsianer	Jewish native of Galicia
gandz	goose
Gantseh K'nacker!	Big Shot
Gantseh Macher	Big shot
Gantseh megilleh	Big deal!
Gantseh mentsh	Manly
Gants gut	Very good
gas	Street
Gatkes	Long winter underwear
Geben shoychad	To bribe
Gebentshte boych	blesses stomach
Gebentsht mit kinder	Blessed with children
Gebrenteh tsores	Utter misery
Gebrochener english	Fractured English
geburts tog	Birthday
Gedainkst?	Remember?
Gedempte flaysh	Mystery meat
Gedicht	ample
Gefelt es dir?	Do you like it?
Geferlech	Dangerous
Geharget zolstu veren!	Drop dead!
Gelaimter	one who drops whatever touchs
Gelibteh	Beloved
Gelt gait tzu gelt	Money goes to money
Gelt is nisht kayn dayge	Money is not a problem
gelt	money
Gembeh!	Big mouth!
Gemitlich	Slowly
gemize	Vegetable
Genaivisheh shtiklech	Tricky
Genevishe oigen	Shifty eyes
Genug iz genug	Enough is enough!
geršt	barley
gesheft	Store, Business
Geshmak	delicious
Geshtorben	The state of being dead
Geshtroft	punished
Geshvollen	Swollen
Getchke	Statue
Get	Divorce
getrank	Beverage
Gevald!	Help!
Gevaldikeh Zach!	A terrible thing!
Gevalt geshreeyeh	good grief
Gevalt!	Heaven Forbid!
Gezunde tzores	Healthy troubles
Gezunt!	Bless you! (when sneezing)
Gezunteh moid!	Brunhilde
Gezunterhait	In good health
Gezunt vi a ferd	Strong as a horse
Gib mir dos!	Give me this!
Gib mir nit kain einorah!	Don't give me a canary!
Gib zich a shukl	Hurry up!
Gib zich a traisel	Get a move on
Gitte neshomah	good soul
glaych	Straight
Gleichvertel	Wisecrack
Glezel tai	Glass of tea
Glezel varms	comforting
Glick	piece of luck
glitz	glitter
Gloib mir!	Believe me!
Glustiyah	Enema
G'nossen tsum emess!	The sneeze confirmed the truth
Goldeneh chasseneh	Fiftieth wedding anniversary
gold	gold
Goniff	Crook
goot	Good
Gopel	Fork
Gornisht	Nothing
gortn	garden
Gote Vorte	A good piece of information
Got in himmel!	God in heaven!
Gotteniu!	Oh God!
Gott lacht	A person plans and God laughs
Got tsu danken	Thank God
Got zol ophiten!	God forbid!
Goy	Any person who is not Jewish
Goyeh	Gentile woman
Goyishe kop	Opposite of Yiddishe kop
Greps	Blech
Gres	Big
Grob	crude
Grober	Coarse
Grober finger	Thumb
Groisseh gedilleh!	Big deal! (1)
Groisser potz!	Big penis!
Grooten	To take after
groys	big
Groyser finger	Middle finger
guf	body
Guggle muggle	A concoction made of warm milk
Gunsel	A young goose
Gut far him!	Serves him right!
Gut gezugt	Well said
Gut	Good
Gut morgn	Good morning
Gutn morgn!	Good morning!
Gutn ovnt!	Good evening!
Gutn tog	Good bye
Gut Shabbos	Good Sabbath
Gut shabes!	Good Saturday
Gut Yontif	Happy Holiday
Gut yor!	Good year
G'vir	Rich man
hadres ponem	handsome person
hafsoke	pause
haftik	persistent
hagam	although
hagdome	preface
hagodl	Haggadah
Haimish ponem	A friendly face
Haiseh vanneh	Hot bath
Haissen	To hate
hakdome	preface
Haken a chainik	Boring
Hak flaish	Chopped meat
hakhnose	provision
haklal	in short
hakmeser	cleaver
hak mir nisht keyn tshaynik!	Stop talking nonsense!
Hak mir nit in kop!	Stop bending my ear
Hak mir nit kayn chainik	Don't get on my nerves
hakn a tshaynik	talk nonsense
hakn	chop
haknkreyts	swastika
halbe levone	parenthesis
halber tog	noon
halb	half
halb tsvelf	11:30
haldzband	necklace
haldzbender	necklace
haldz	neck
haldzn	embrace
halel	hallel
halevay	If only...
Halevei!	If only...
Halo	Hello
halokhe	Jewish religious law
haltn a red	make a speech
haltn far	consider
haltn fun	be fond of
haltn	hold
hamer	hammer
Hamoyn	Common people
handlen	trade, to do business
hanoe	enjoyment
hanoe hobn	have a good time, to enjoy
hant	hand
hantshrift	handwriting
harb	severe
harbst	Autumn, fall
harbstik	autumnal
harbsttsayt	harvest time
hargenen	kill
hargen	kill
harmoshke	harmonica
Harte mogen	constipation
hartse	darling!
hartsenyu	darling!
harts	heart
Hartsvaitik	Heart ache
hartsveytik	heartache
hasbore	opinion
hashore	guess
hashpoe	influence
hashtone	urine
haskhole	beginning
haskole	Haskalah; the Jewish movement
haskome	consent
hatikvo	Hatikvah; the Israeli anthem
hatslokhe	success
havaye	grimace
havdole	Havdole
havdoles	versus
havken (oyf)	bark (at)
hayeh	animal
hayes	life
hayfl	clump
Hay!	Hey!
haynt bay nakht	tonight
hayntik	today's
Haynt	Today
haynttsaytik	current
haynttsutog	these days
hayorik	this year's
hayyor	this year
hazer	pig
hazshgokhe	care
Heavy rain	Heavy rain
hebreish	Hebraic
Hecher	Louder
hefker	stray, A mess
heft	notebook
heftpunkt	juncture
hegdesh	filthy place
hegdeyshim	filthy place
Heizel	Whorehouse
Hekdish	Decrepit place
hekl	hatchet
held	hero
heldin	heroine
Heldish	Brave
Heldzel	Stuffed neck flesh
heldzer	neck
heldzl	neck of a chicken
helfand	elephant
helfn	aid
helft	half
hemd	shirt
hemshekh	continuation
hemsheykhim	continuation
Hendl	Chicken
hengendik	baggy
hengen	hang
hentshke	glove
heore	footnote
herefayendik	instantly
herefayen	instant
Her	Mr., Mister
hern	hear
heroish	heroically
hershaft	rule
hersher	ruler leader
hersh	Hersh
hershn	rule
Hert zich ein!	Listen here!
heskem	agreement
heslekh	hateful
hesofe	appendix (written)
Hetsken zich	Shake and dance with joy
hetsn	incite
heybn a hant	lift a hand to
heybn	lift
hey	hay, hey; 5th letter of alphabet
heyl	cavern
heylikayt	holiness
heylik	holy
heyln	heal
heylung	heal
heym	home
heymish	domestic
heymshtet	hometown
heymshtot	hometown
heypekh	opposite
heyrat	marriage
heys	hot
heysn	be named
heyst es	consequently
hiderdik	gorgeous
hig	belonging here
Hikevater	Rear
hilel	Hillel
hilf	aid
hilfsverb	auxiliary verb
hilkhas	religious law of
hilkhes	religious law of
hilkhik	resounding
hilkhndik	resounding
himl	heaven, sky
hind	doe
hiner	chicken
hinken	limp
hintele	baby dog
hintergrunt	background
hinter	in back of
hintl	puppy
hintn	in back
hipopotam	hippopotamus
hipotek	mortgage
hipsh	considerable
hirsh	deer
hislayvesdik	enthusiastic
hislayves	enthusiasm
hispayles	enthusiasm
hitl	women's hat
Hitsik	Hothead
Hitskop	Excitable person
hitsn zikh	be excited
Hit zich!	Look out!
h'	Mr.
Hob derech erets	Have respect
Hob dir in arbel	I've got you by the elbow
Hoben tsu zingen un tsu zogen	Have no end of trouble
hobn an oyg oyf	have in prospect
hobn fant	dislike
hobn groyse oygn	be greedy, To be greedy
hobn	have
Hob nit kain deiges	Don't worry
hobn mitgefil	sympathize
hobn tayne tsu	admonish
Hock mir nisht en chinik	Don't hit me in the head
hodeven	grow something
hofenung	hope
hofn oyf	hope for
hofn tsu	hope to
Hoizer gaier	Beggar
Hoizirer	Peddler
Hole Loch in kop	Hole in the head
holeptses	stuffed cabbage
Holishkes	Stuffed Cabbage
holts	wood
honik	honey
hopken	hop
horav	Rabbi
hore	hora a Jewish dance
horeven	labor
horizont	horizon
horn	horn
Host du bie mir an avleh!	So I made a mistake
hot ir...	Do you have...
Hot tzayt	Take it easy
hoydesh	month
hoyf	yard
hoykh	high
hoypt	chief
hoyptkvartir	headquarters
hoyptshtot	capitol (city)
hoyptzakh	most important thing
hoyt	skin
hoyzgezind	members of a household
hoyz	house
hoz	hare
hozn nisl	hazelnut
hulien	carouse
Hulyen	A hellraiser
hun	chicken, hen
hundert	one hundred, hundred
hundertst	hundredth
hunger	hunger
hungerik	hungry
hunt	dog
hur	*****
huragan	hurricane
hust	cough
hustn	cough
Hust!	Quiet!
hut	hat
Ibberbuttle	Senile
iber	above
iber a yor	next year
iberayor	next year
iberbaysn	breakfast
iberBETn	beg pardon of
iberblaybn	remain
iberblik	survey
iberdek	bedspread
iberfaln	ambush
iberfirn zikh	become spoiled
iberflantsn	transplant
ibergang	transition
ibergebn	communicate
ibergegebn	devoted
iber hoypt	chiefly
iberike	rest
iberikeyt	redundancy
iberiks	overly
iberik	superfluous
iberkerenish	upset
iberkern	overturn
iberkhazern	repeat
iberkumen	survive
iberlebn	experience
iberlebung	experience
iberleyenen	read
iberleygn	put in another place
iberlozn	leave behind
ibermakhn	change
iber morgn	day after tomorrow
ibermorgn	day after tomorrow
ibernakhtik	overnight
ibernatirlekh	supernatural
ibernekhtikn	stay overnight
ibernitseven	revamp
ibern	over the
iberrashn	surprise
iberrashung	surprise
iberraysn	interrupt
ibershlogn	interrupt
ibershprayzer	offender
ibershraybn	copy
ibershrekn	frighten
ibertraybn	exaggerate
ibertretn	step over something
ibertsaygik	convincing
ibertsaygn	persuade
ibertsaykhnen	trace a drawing
ibertseyln	count
iberzetsn	translate
iberzetsung	translation
iberzogn	repeat
Ich bin ahntoisht	I am disappointed
Ich bin dich nit mekaneh	I don't envy you
ich dank aych zeyer	Thank you very much
Ich darf es ahf kapores	It's good for nothing!
Ich eil zich (nit)	I am (not) in a hurry
ich farshtey nisht	I do not understand
Ich feif oif dir!	I despise you!
Ich gai chaleshen bald avek	I'm about to faint
Ich hob dich in bod!	To hell with you!
Ich hob dir!	Go flap you ears!
Ich hob dir lieb	I love you!
Ich hob es in drerd!	To hell with it
Ich hob im feint	I hate him
Ich hob im in bod!	To hell with him
Ich hob mir fer pacht	I have you in my pocket
Ich hob nicht kain anung	I have no idea
ich	I
Ich ken dir nisht farfeeren	I can't lead you astray
Ich loif	I'm running
Ich vais nit	I don't know
Ich vel dir geben a khamalye	I'll give you such a smack
Ich vel dir geben kadoches!	I'll give you nothing!
ich vel es koyfn	I'll buy it
ich volt gevolt koyfn...	I would like to buy...
Ich yog zich nit	I'm not in a hurry
ideal	ideal
idealist	idealist
identifitsirung	identification
identitet	identity
ideologish	ideological
ideye	idea
idey	idea
idiomatish	idiomatic
idiom	idiom
idiot	idiot
i dos	even then
ignorirn	ignore
i...i	both...and
ikerdik	essential
iker	principle, people of substance
Ikh badarf a doktor	I need a doctor
Ikh badoyer	I'm sorry
ikh bet dikh	please (1)
Ikh bin amerikaner	I'm American
Ikh bin daytsh	I'm German
Ikh bin farloyrn	I'm lost
Ikh bin funem Amerike	I'm from the U.S
Ikh bin funem Daytshland	I'm from Germany
Ikh bin funem Yisroyl	I'm from Israel
Ikh bin hungerik	I'm hungry
Ikh bin iberzetser	I work as a translator
Ikh bin soykher	I work as a businessman
Ikh bin teykef tsurik!	I will be right back!
Ikh bin traytsik yorn alt	I'm thirty years old
Ikh bin tsvantsik yorn alt	I'm twenty years old
Ikh bin yisroyli	I'm Israeli
Ikh farshtay	I understand
Ikh farshtey dos nit!	I don't understand!
Ikh fli krank	I feel sick
Ikh heys...	My name is...., My name is...
Ikh hob dikh lib	I love you
Ikh hob dikh lib!	I love you!
Ikh hob nit keyne idey	I have no idea
Ikh lern mikh zint Yidish	I've been learning Yiddish
Ikh	Me, I, ego
Ikh muz gebn.	I have to go
ikh vet zikh mit dir oyf ....	I'll bet you...
Ikh vis nit!	I don't know!
Ikh voyn inem Amerike	I live in the U.S
Ikh voyn inem Daytshland	I live in Germany
Ikh voyn inem Yisroyl	I live in Israel
Ikh zukh Yohan	I'm looking for John
I know	I know
ikrim	principle
iks	"the letter ""X"""
ile	young genius
iluim	young genius
ilustratsye	illustration
ilustrirtn	illustrate
iluzye	illusion
imigrant	immigrant
imigratsye	immigration
imigrirn	immigrate
imperativ	imperative
improvizatsye	improvisation
impuls	impulse
imyirtseshem	God willing
in algemeyn	generally
in a novene	for a change
In a noveneh	For a change
in a yor	in a year
indeks	index
in der emesn	in truth
in der fremd	abroad
In der fri	In The Morning
in der mit	in the middle
in der oysland	abroad
in der praktik	practice
In di alteh guteh tseiten!	In the good old days!
indik	turkey
In di oygn	To one's face
individuel	individual
in drerd arayn!	go to hell!
In drerd mein gelt!	My money went down the drain!
industrye	industry
indzl	island
inem	in the
inem ovnt	evening
inerlekh	internal
ineveynik	inside
in eynem	together
in eyn shmey drey	quickly (humorous)
informatsye far turistn	Tourist Information
informatsye	information
ingantsn	totally
ingber	ginger
in gikhn	quickly
inhalt	contents
in	into
initsyativ	initiative
In miten drinen	In the middle of
inmitn	in the middle
in shtub	at home
inspiratsye	inspiration
inspirirn	inspire
instalirn	install
instants	division
instinkt	instinct
instinktiv	instinctive
institut	institute
institutsye	institution
instruktsye	instruction
integrirn	integrate
intensiv	intensive
interesant	interesting
interesirn	interest (somebody)
interesirn zikh mit	take an interest in
internatsyonal	international
internets	internet
intervyu	interview
intervyuiren	interview
intim	intimate
intsident	incident
in veg	under way
inyen	matter
inyonim	matter
inzhenir	engineer
ion	ion
Ipish	Bad odor
Ir gefelt mir zaier	You please me a great deal
irgun	Irgun
ironish	ironic
ironye	irony
irs	hers
ir	you
is bei a shikkeren oyfen tsung	a drunk has on his tongue
ishe	female
italye	Italy
italyener	Italian (person)
itlekh	every
itster	now
itstik	current
itstike tsayt	present tense
itst	now
ivri	person
ivrit	Hebrew
ivritish	Hebraic
Iz brent mir ahfen hartz	I have a heartburn
Iz es dir do gefeln?	Did you like it here?
iz gegangen	went
Kaas in kaas oyf	Angry with
Kabaret forshtelung	Floorshow
kabole	Cabala
kabtsn	poor person
kabtsonem	poor person
Kabtzen	Pauper
Kaddish	A mourner's prayer
Kaddishel	Baby son
kadeyshim	Kadish
kadish	Kadish
kadmoynish	primevil
Kadoches	Fever
Kadoches mit	Absolutely nothing!
kadokhes	fever marked by chills
Kakapitshi	Conglomeration
kakn	defecate
Kalamutneh	Dreary
kale	bride
kaledzh	college
kalemutne	gloomy
kaliedik	spoiled food
kalifornye	California
kalifyor	cauliflower
kalium	potassium
kalkh	calcium
Kalleh	Bride
Kalleh moid	A girl of marriageable age
Kallehniu	Little bride
Kalta neshomeh	A cold soul
kaltblutik	cold blooded
kalt	cold
kaluzhe	puddle
Kalyeh	spoiled
Kam derlebt	Narrowly achieved
Kam mit tsores!	Barely made it!
Kamtsoness	To be miserly
Kam vos er kricht	Barley able to creep
Kam vos er lebt	He's hardly (barely) alive
kanade	Canada
kanal	sewer
Kaneh	An enema
kantate	contata
kapele	small hat
kapelye	band musical
kapelyush	hat
kapitl	chapter
Kaporeh	Atonement sacrifice
kapores	Atonement sacrifice
kapore	scapegoat
kapoyer	reverse
kaptsen	Pauper
kaput	dead
Karabeinik	Country peddler
Karger	tightwad
karlik	small person
karš	cherry
karsh	cherry (sweet)
karte	map
kartofl	Potato
Kaseer	enema
Kasheh	Groats
Kasheh varnishkes	Cooked groats and broadnoodles
kashe	porridge, question
kashes	question
kashres	Jewish dietary laws, kosherness
Kashress	Kosher condition
Kasnik	Angry person
kastn	box
Katchka	Duck
kategorye	category
katoves	joking
kats	cat
katsef	butcher
Katshkedik	Ducky
katshke	duck
katsovim	butcher
Katzisher kop	Forgetful
kauboy	cowboy
kave	Coffee
kavene	watermelon
kavone	intention
Kaynahorah	the evil eye
Kazatskeh	Lively Russian dance
kdoyshim	holy man
kdushe	sanctity
keday	worthwhile
kedey	so that
kegner	opponent
kehanim	priest (Jewish)
kehune	priesthood
Kein briere iz oich a breire	Not to have any choice
keisenik	Angry person
kelnerin	waitress
kelnershe	waitress
kelner	waiter
kemat	almost
Kemfer	Fighter
kemfn	struggle
keml	camel
keneged	as opposed to
kenen	know
Kenen oyf di finger	Have facts at one's fingertips
Ken ikh dikh oyshelfn?	Can I help you?
Kenstu dos nokhamol iberzogn?	Can you say it again?
Kenstu mikh oyshelfn?	Can you help me?
kentenish	knowledge
kentshaft	knowledge
Ken zein	could be
kepele	A life on your head
kerndl	nucleus
kern zikh	turn oneself
kerper	body
keseyder	continually
keseyderdik	constant
keshene	pocket
kest	chestnut
kestl	box
ketsele	little kitty
ketsl	kitten
Ketzele	Kitten
keylem	receptacle, dish
keyle	receptacle, dish
keynahore	No Evil Eye!
keyn ayenore	No Evil Eye!
Keyne problem!	No problem!
keyner	nobody
keyn eynhore	No Evil Eye!
keyn eynore	No Evil Eye!
keyn mol nisht	never
keyn	to
keysekh	Easter
keyver (kvorim)	grave (burial)
kez	cheese
khagoes	holiday
kha kha	ha ha
khale	Challah
khal	occurs
khaloshesdik	nauseating
khaloshes	faint
khaloymes	dream (in sleep)
khalupe	hut, apartment
khalutsim	pioneer
khane	Khane
khanfenen	flatter
khanike	Hanukkah
khap a nash	grab a bite to eat
khapn a dreml	take a nap
khapn	catch
kharekter	character
khareydim	Jew who is strictly observant
khareydish	strictly observant
kharote hobn	repent
kharote	regret
kharoysies	brown
kharpe	disgrace
khasanim	bridegroom
khasene hobn	get married
khasene	marriage
khasene tsu hobn mit...	marry
khasidim	follower
khasmenen	seal
khate	cottage
khave	Chava
khaver	friend
Khaver!	Friend!
khaverish	friendly
khavern zikh	be friends
khavershaft	friendship
khaverte	girlfriend
khaveyrim	friend
khaviv	beloved
khay	alive
khayel	army
khayes	life
khayoles	army
khazal	sages
khazeray	filth
khazern	repeat
khazer	pig
khazeyrim	pig
khazn	Cantor
khazonim	Cantor
khesboynes	account
khesed	favor
kheshbn	account
kheshbn firer	accountant
khes	khes; 8th letter of alphabet
khevre	gang of friends
khevreman	guy
kheyder	Jewish religious school
kheyfets	thing
kheylek	portion
kheyn	charm
kheynevdik	cute
kheyshek	eagerness
khezboynes	account
khezhbm	account
khezhbm firer	accountant
khiber	bond
khiburem	bond
khidesh	innovation
khideshn zikh	be surprised
khidish	innovation
khikhen	giggle
khikhiken	giggle
khilek	difference
khilel	desecration
khilukim	difference
khilulim	desecration
khine	China
khinekh	dedication
khinezer	Chinese (person)
khinezish	Chinese
khirek	vowel sign in Yiddish
khirek yud	yud with a khirek
khitrak	sly person
khitre	cunning
khkire	speculation
khmare	cloud
khnifenik	flatterer (male)
khnife	toadying
khnufe	flatterer (female)
khof	khof; 12th letter
khoge	holiday
khokhem	wise man
khokhme tson	wisdom tooth
khokhme	wisdom
kholel	hollow
kholem	dream (in sleep)
kholemen	dream (in sleep)
kholere	cholera
kholerye	cholera
kholets	pioneer
kholile	God forbid!
kholile vekhas	God forbid!!!
khol	less holy
khomets	leavened dough
khomishoser bshvat	Tu Bishvat; New Year's day
khomishoser	fifteenth day of the month
khor	chorus
khored	Jew who is strictly observant
khorev	destroyed
khorev makhn	annihilate
khosed	follower
khosedl	Hasidic dance
khoshev	important dignitary
khosid	follower
khosn	bridegroom
khosnkale	bride and groom
khotsh	although
khoydeshlekh	monthly
khoyle	sick person
khoyshed	suspicious
khoyshekh	darkness
khoyvas	obligation of
khoyv	obligation
khoyzek	ridicule
khreyn	horseradish
khropen	snore
khroyses	brown
khshives	importance
khshuvim	important dignitary
khsides	Hasidism
khsidim	follower
khsime	seal
khupe	wedding canopy
khurbm	the Holocaust
khurbn	ruin
khurbones	the Holocaust
khurve	ruin
khushemdik	sensual
khuts	besides
khutspedik	audacious
khutspe	gall
khvalye	wave
Kibbitzer	Meddlesome spectator
kibed	tribute
kibets	community
kibetsen	kibitz
kibitser	onlooker
kibl	bucket
kibudim	tribute
kibutsim	community
kibuts	Kibuts
Kiddish	Blessing over wine
kidesh	the prayer over wine
kiem	survival
kikh	kitchen
kikhl	cookie
kiln	cool
kilometer	kilometer
kiml	caraway (seeds)
kimlshtoyb	dash of caraway
kimpet	childbirth
kimpetkind	newborn infant
Kimpetoren	Woman in labour
kimpetorin	woman in childbirth
kin	chin
kind	child
kinder	child
kinderhiter	babysitter
Kinderlech	Diminutive
kinderlekh	dear children
kindheyt	childhood
Kind un kait	Young and old
kindvayz	in childhood
kine	jealousy
kinigin	queen
kinig	king
kinigl	bunny
kinobild	movie picture
kino	movie theater
kinstler	artist
kinstlerish	artistic
kirche	Church
kirkh	church
kirtsung	abbreviation
kishef	charm, spell
kishefdik	magical
kishefmakher	magician, magical
Kishkeh	Stuffed derma
Kish mir en toches	Kiss my backside
kishn	cushion
kishufim	spell
kislev	Kislev; 3rd month of calendar, Kislev; 3rd month
Kitsel	Tickle
kitser	summary
kitslen	tickle
kitsurim	summary
klafte	bitch
Klainer gornisht	Little prig
klal....nisht	not at all
klal	standard
klal yidish	standard Yiddish
klang	rumor
Klaperkeh	Talkative woman
klavyatur	keyboard
klaybn	collect
klemen	grieve
klemen zikh	grieve
klemerl	paper clip
Klemt beim hartz	Clutches at my heartstrings
kleptsetl	tab
klern	think
kletser	wooden beam
kletsl	block of wood
kleyd	dress
kley	glue
kleyngelt	change coins
kleyn	small, little
kleyntshik	tiny
klezayen	weapon
klezmerish	musical
klezmer	musician
klezmorem	musician
klingen	ring
Klipeh	Gabby woman
kli	vessel
Klogmuter	Complainer
klogn	wail
klogn zikh oyf	complain
klog	woe, Plague
klole	curse
klolim	standard
Kloolye	A curse
Klop	Bang
klops	meat loaf
klor	clear
klots (kletser)	log (wood)
klots	wooden beam
Klotz kasheh	Foolish question
Klotz	Ungraceful
kloymersht	apparently, Not in reality
kloyster	church
kloyz	small synagogue
klub	club
kluger	smart person
klugshaft	wisdom
klug	wise
klung	phone call
klutz	Ungraceful
klyamke	handle
Knacker	A big shot
Knackerke	The distaff k'nacker
knafl	heel of a shoe
Knaidel	cooked in soup
k'naidlech	cooked in soup
knaklen	rumble
knakn mit	snap
knakn	snap
knap	meager
knekhl	knuckle
knekht	slave
knep	button
knepl	button
knepllekher	button hole
knepllokh	button hole
kneydl	dumpling
kni	knee
knipl	nest egg
knip	nip
Knippel	knot
Knishes	Baked dumplings filled
knish	knish, Vagina
knoblbroyt	garlic bread
knobl	garlic
knop	button
knup	junction
kobrets	carpet
Kochalain	Summer boarding house
Kochedik	excitable
Kochleffel	One who stirs up trouble
kod	code
kodesh	holy man
kokhedik	boiling hot
kokhlefl	meddler
kokhn	boil
kokhn mit	be in turmoil
kokhn zikh	be excited
kolaminim	kinds, all kinds of
koldre	blanket
kolege	colleague (masculine)
kolegin	colleague (feminine)
kolerley	all kinds of
kolir	complexion
kolirik	colorful
kolirt	colored
kolnerbeyn	collar bone
kolner	collar
kolnidre	prayer recited on Yom Kipur
komande	command
komediye	comedy
komedye	comedy
komets o	rudimentary knowledge
komiker	comedian
Komisch	Funny
komish	comical
komitet	committee
komponent	component
kompyuter	computer
konen	know
konferents	conference
kongres	congress
konstruktsie	construction
kontekst	context
kontrol	controls
kontroversyal	controversial
kontsert	concert
konverb	adverbial complement
kool	public
koordinirn	coordinate
kop	head
Kop oif di plaitses!	Good
Kopvaitik	Headache
kopveytik	headache
korbm	victim
korbones	victim
korekt	correct
korektor	proofreader
korektorshe	proofreader (female)
korespondent	correspondent
korespondents	correspondence
korespondirn	correspond
korev kroyvim	relative
kort	playing card
koshe	difficult
Kosher	Kosher, Jewish dietary laws
koshern	prepare food for Passover
koshken	pamper
kosmish	cosmic
kosmos	cosmos
kosmosshif	space ship
kostum	costume
koved	dignity, Respect
koydem	first of all
koydem kol	in the first place
koyekhdik	powerful
koyekhes	strength
koyekh	strength
koyenim	priest Jewish
koyen	priest Jewish
koyl	bullet, coal
koyleldik	overall
koyles	loud noise
koyletsh	twisted white bread
koymen	smokestack
koym	scarcely
koyses	goblet
koyshbol	basketball
kozak	Cossack
krab	crab
kraftik	vigorous
kraft	power
krakh	crash
krankeyt	illness
krank	ill, Sick
krankshvester	nurse
krasavitse	beautiful woman
Krassavitseh	Beauty
kratsn	scratch
krayd	chalk
krayz	circle
Krechtser	a moaner
Krechts	moan
krem	cream
kremerke	storekeeper (female)
kremer	storekeeper (male)
krenk	sickness
Kreplach	Small pockets
krepl	dumplings filled with meat
kreplekh	dumplings filled with meat
kretshmer	innkeeper
kretshme	tavern
kreynen	crown
krigl	jug
krign	receive
krign zikh	argue
krig	quarrel
krikhik	crawling
krikhn	crawl
krist	Christian (person)
kristlekh	Christian
kritik	criticism
kritiker	critic
kritikirn	criticize
kritish	critical
krizis	crisis
kro	crow
Kroivim	Relatives
Krolik	Rabbit
krom	shop
kroyn	crown
kroyt	cabbage
kroyz	curl of smoke
krupnik	barely soup
ksav	handwriting
ksavya'd	manuscript
ksovem	handwriting
ksube	wedding contract
kubik	cup
Kuck im on	Defecate on him
Kuck zich oys!	Go take a shit for yourself
kuf	kuf; letter of the alphabet
Kugel	Pudding
kugl	kugel
kukher	chef
kukhn	cake
Kuk!	Look!
Kukn durkh di finger oyf	Shut one's eyes to.....
kukn	look (at)
kukvinkl	point of view
kulikl	mitten
kulminirn	culminate
kultur	culture
kumedikeyt	future
kumen	arrive
kumendik	future
kumen tsu a shlus	come to a conclusion
kumen tsu gast	visit, To visit
kum ich morgen	I'll come tomorrow
Kum ich nisht heint	If I don't come today
Kum mit mir!	Come with me!
Kuni leml	A nerd
kunst	art
Kuntzen	Tricks
Kunyehlemel	Naive
kuper	copper
Kuppe drek	A piece of fecal matter
kuropate	partridge
kurort	resort
kurs	flight (airplane)
kurtse heyzlekh	shorts
kurtskes	shorts
kurts	Short
kurva	*****
Kurveh	prostitute
kurve	*****, prostitute *****
Kush in toches arein!	Kiss my behind
Kushinyerkeh	Cheapskate
kush	kiss
kushn	kiss
kutshme	Persian wool hat
kuzin	cousin (male)
kuzine	cousin (female)
kvadratfus	square foot
kvadrat	square
kvalifitsirt	skilled
kvaln	well
kval	source
kvartldik	quarterly
kvarts	quartz
K'vatsh	Boneless person
K'velen	Glow with pride
kveln	beam with pride
kvenklen zikh	hesitate
kver	crosswise
kvetsh	complainer
kvetshn	squeeze
K'vetsh	Whine
kvitl	tab
K'vitsh	screech
kvoder	quarter (25 cents)
kvort	quart
sonim!	A curse on my enemies!
