à carreaux	checked		
à dimanche	see you sunday		
à l'aéroport	at the airport		
à l'étranger	abroad		
à la gare	at the train station		
à la mode	in style		
à la pharmacie	at the pharmacy		
à la superette	at the convenience store		
à mon avis	in my opinion		
à mon propre compte	for myself		
à pois	polka dotted		
à quelle heuere est le film	what time is the movie at		
à rayures	striped		
à sept heures, je faisais mes devoirs	at seven oclock, i was doing my homework		
à toute vitesse	very quickly		
à, en, dans, chez, sur, sous	y replaces anything introduced by a place preposition such as		
achetais, achetais, achetait, achetions, achetiez, achetaient	acheter imparfait conjugations		
achète, achètes, achète, achetons, achetez, achètent	conjugate acheter in present		
achèterai, achèteras, achètera, achèterons, achèterez, achèteront	conjugate acheter in future		
achèterai, achèteras, achètera, achèterons, achètez, achètont	acheter in future		
achètes-en	buy some		
affreux	awful		
alla, allèrent	aller passe simple		
aller à la pêche	to go fishing		
aller à pied	to walk		
aller aux états-unis	to go to the united states		
aller dans les magasins, faire des achats	2 ways to say to go shopping		
allons-nous dîner au restaurant	let's eat out		
allons-nous faire des achats	let's go shopping		
allume la climatisation	turn on the air conditioning		
allumer, mettre	to turn on		
annuler ma réservation	to cancel my reservation		
apercevoir	to see, catch sight of		
apercevr	apercevoir stem		
appellerai, appelleras, appellera, appellerons, appellerez, appelleront	conjugate appeler in future		
apportez-nous une pizza	buy us a pizza		
arriver, se passer, avoir lieu	two ways to say to happen		
arroser les plantes	to water the plants		
assieds-toi, asseyez-vous	sit down, formal and informal		
assister à	to attend	deck#2	due@2021-10-25 19:07:47
au moment où	just as		
au printemps	in spring		
au revoir	goodbye		
au salon de coiffure	at the hair salon		
augment le chauffage	turn up the heat		
aujourd'hui, c'est lundi, demain, c'est mardi	today is monday, tomorrow is tuesday		
aurai, aura, auras, aurons, aurez, auront	conjugate avoir in future		
aurais, aurais, aurait, aurions, auriez, auriaent	conjugate avoir in conditionnel		
avale la médecine	swallow the medicine		
avant de tu es venu ici, j'étais heureuse	before you came here, i was happy		
avant-hier	the day before yesterday		
avec une carte de crédit	with a credit card		
avocat	lawyer		
avoir besoin de	to need (to)		
avoir de la chance	to be lucky		
avoir deux heures de retard	to be two hours late		
avoir faim, avoir soif	to be hungry, to be thirsty		
avoir l'air	to look/appear		
avoir la grippe	to have the flu		
avoir le visage carré	to have a square face		
avoir le visage ovale	to have an ovular face		
avoir le visage rectangulaire	to have a rectangular face		
avoir le visage rond	to have a round face		
avoir les cheveux blonds	to have blond hair		
avoir les cheveux bouclés	to have curly/wavy hair		
avoir les cheveux bruns	to have brown hair		
avoir les cheveux châtain	to have chestnut colored hair		
avoir les cheveux châtain clair	to have gold colored hair		
avoir les cheveux châtain foncé	to have fancy brown hair		
avoir les cheveux courts	to have short hair		
avoir les cheveux frisés	to have curly/frizzy hair	deck#2	due@2021-10-25 19:07:06
avoir les cheveux lisses	to have straight hair		
avoir les cheveux longs	to have long hair		
avoir les cheveux noirs	to have black hair		
avoir les cheveux roux	to have red hair	deck#2	due@2021-10-25 19:08:20
avoir les yeux bleus	to have blue eyes		
avoir les yeux gris	to have grey eyes		
avoir les yeux marron	to have brown eyes		
avoir les yeux verts	to have green eyes		
avoir mal	to be in pain		
avoir mal à la tête	to have a headache		
avoir mal au dos	to have a backache		
avoir mal au ventre	to have a stomachache		
avoir mal aux oreilles	to have an earache		
avoir raison, avoir tort	to be right, to be wrong		
avoir trente minutes d'avance	to be thirty minutes early		
avoir un rhume	to have a cold		
baisse l'air conditionné	turn down the air conditioning		
balayer le sol	to sweep the floor		
belgique	la seule frontière ouverte est celle qui sépare la france de la		
bien situé	well located		
blanc, blanche	white, masc and fem		
bleu clair	light blue		
bleu foncé	dark blue		
blonde	blonde		
body of water to the south	la mer méditerranée		
body of water to the west	l'Océan atlantique		
bon, important, naturel, dommage, indispensable, normal, essentiel, juste, utile	il est ---- que... using subjonctif		
bonne idée	good idea		
brillant, terne	shiny and dull		
bronzer	to get a tan		
brune	brunette		
bruyant	noisy		
buvais, buvais, buvait, buvions, buviez, buvaient	boire imparfait conjugations		
c'est celui de ma soeur	this one is my sister's		
c'est chouette	it's neat!		
c'est combien, ça fait combien	how much is it		
c'est difficile	it's difficult		
c'est drôle	it's funny		
c'est drôle	that's funny		
c'est facile	it's easy		
c'est faux	it's false		
c'est faux	that's false		
c'est génial	it's terrific		
c'est le plus grand musée	it's the biggest museum		
c'est le premier janvier	it's the first of january		
c'est le trente-et-un octobre 2017, on est le trente-et-un octobre 2017, nous sommes le trente-et-un octobre 2017	three ways to say it's october 31st 2017		
c'est meilleur marché	this is cheaper		
c'est pénible	it's a pain, it's annoying		
c'est quand, ton anniversaire	when's your anniversary		
c'est super	it's great		
c'est tout, merci	that's all, thanks		
c'est votre tour	it's your turn		
c'est vrai	it's true		
ça fait six euros cinquante	that makes/that comes to six euros fifty		
ça s'arrangera	things will be okay		
ça s'est passé, ça a eu lieu, c'est arrivé	3 ways to say it happened		
ça va mieux	i'm feeling better		
ça va très bien	it's going very well		
ça va très mal	it's going awful		
ça vous fait mal	does it hurt		
ce bottes vous vont	do these boots fit you		
ce camion est vraiment grand	that truck is really big		
ce colis, ce paquet	2 ways to say this package		
ce manteau me plaît	i like this coat		
ce manteau me va bien	this coat fits me well		
ce que	replaces la chose/les choses que		
ce qui	replaces la chose/les choses qui		
ce sera prêt tout à l'heure	it will be ready in a little while		
célibataire	single		
cent	100		
cette boîte est légère, ce n'est pas lourde	this box is light, it's not heavy		
cette camionnette est plutôt petite	that van is pretty small		
cette carte postale	this postcard		
chaud, tiède, froid	hot, warm, cold		
cher, chère	expensive		
chercher	to look for		
chez le cordonnier	at the shoe repair shop		
chez le photographe	at the photo shop		
chez le teinturier	at the cleaners		
clair	sunny		
classer des documents	to file documents		
combien coûte l'oeuf	how much does the egg cost		
combien en voulez-vous	how many do you want		
combien est-ce que je vous dois?	how much do i owe you		
comme ci, comme ça	it's going okay		
Comme il pleuvait, Lise n'est allée nulle part	As it was raining, Lise didn't go anywhere		
comment allez-vous	how are you formal		
comment t'appelles-tu	what's your name		
comment te sens-tu	how do you feel		
compter	to plan, to count on		
conditionnel	--- form of vouloir, pouvoir, devoir is more polite		
content, heureux, ravi	three ways to say happy		
couper les cheveux à quelqu'un	to cut someone's hair		
courbé	rounded, arched		
courir	to run		
courte	short		
couvrir	to cover		
croire, penser, être sûr, être certain, il est sûr, il est certain	six terms that if they're negative, they use the subjonctif		
crois, crois, croit, croyons, croyez, croient, cru	all the conjugations of croire including passe compose		
d'abord	first		
d'après moi	according to me		
d'habitude, habituellement	usually		
d'ici une semaine	a week from now		
d'occasion	secondhand		
d'où est-ce que tu viens	where are you coming from		
Dans l'avion il faut attacher sa ceinture de sécurité	in the plane is is necessary to attach the seatbelt		
de	you can use dont for any object introduced by		
de l'amitié, de l'affection, de la sympathie, de l'admiration	friendship, affection, liking, admiration		
de l'aspirine	some aspirin		
de l'ouate	some cotton wadding		
de la colle	some glue		
de la ficelle	some string		
de la lessive	some detergent		
de quelle couleur...?	what color...?		
de temps en temps	from time to time		
débarrasser	to clear the table		
découvrir	to discover		
déçu	disappointed		
dégager	to shorten (hair)		
dégagez-les, coupez-les-moi courts	two ways to say shorten it (hair)		
démarrer	to start the car		
démodé	out of style		
derrière	in the back		
des bottes	boots		
des chaussettes	socks		
des chaussures	shoes		
des chevaux	horses		
des comprimés, des cachets, des gouttes	medicine can come in three forms		
des diapos	some slides		
des éclairs	lightning		
des enveloppes	some envelopes		
des garçons cools n'ont que des motos	cool boys only have motorcycles		
des nuages, de la brume, et du brouillard	some clouds, some mist, and some fog		
des oiseaux	birds		
dès que, aussitôt que	two ways to say as soon as		
des régions de collines	le paysage en normandie		
des régions très montagneux	le massif central, les vosges, les pyrénées, le jura, les alpes		
des sandales	sandals		
des tennis	tennis shoes		
des timbres	some stamps		
des vitamines	some vitamins		
descendre	to get off		
descends les valises	bring down the suitcases		
Deux jours se sont passés	Two days went by		
développer ces photos	to develop the photos		
devenir	to guess		
deviendr	devenir stem		
devoir	to owe		
devr	devoir stem		
devrai, devras, devra, devrons, devrez, devront	conjugate devoir in future		
dimanche	sunday		
dis donc!	hey there!		
dis!	say! hey!		
donne-la-moi	give me your address (pronouns)		
donne-lui-en	give some stamps to her		
donner à manger au lapin	to feed the rabbit		
donner un coup de main à quelqu'un	to do a favor for someone		
donnez m'en deux	donnez-moi deux blocs de papier (redo with en)		
donnez-m'en dix	give me ten		
dormais, dormais, dormait, dormions, dormiez, dormaient	dormir imparfait conjugations		
doux et humide	le climat en normandie, bretagne, et à paris		
driving	la conduite		
du papier à lettre	some stationery		
du scotch	some scotch tape		
du sopalin	some paper towels		
du verglas	sheet ice		
dur, flexible, mou, molle	hard, flexible, soft (masc and fem)		
écoute ce DC	listen to this cd		
écris-moi quand tu seras à nice	write me when you are in nice		
écrivais, écrivais, écrivait, écrivions, écriviez, écrivaient	écrire imparfait conjugations		
élégant	elegant		
élevé	raised		
elle a apporté le poisson à la fête	she brought the fish to the party		
elle a des taches de rousseur	she has freckles		
elle a des vertiges	she has dizzy spells		
elle a écrit à mon oncle	she wrote to my uncle		
elle attend le tren	she is waiting for the train		
elle est athlétique	she is athletic		
elle est de mauvaise humeur	she's in a bad mood		
elle est en colère	she is angry		
elle est grande	she is tall		
elle est mince	she is thin		
elle est tendue	she's tense/uptight		
elle lui achète une bague	she buys a ring for him		
elle m'a montré sa cicatrice	she showed her scar to me		
elle me l'a présenté	she introduced him to me		
elle refuse de me donner d'argent	she refuses to give me money		
elle s'est lavé les mains	she washed her hands		
elle s'est lavé les mains	she washed her hands		
elle s'est lavée	she washed		
elle s'est lavées	she washed herself		
elle s'est noyée l'année dernière	she drowned last year		
elle s'est souvenue	she remembered		
elle va me faire un pansement et elle va me mettre des sutures	she will bandage me up and give me stitches		
elle va prendre le train suivant/le prochain train	she will take the next train		
elle veut que tu viennes maintenant	she wants you to come now		
elle vient	she comes		
elles décident de s'aimer	they decide to love each other		
elles ne me vont pas	they don't fit		
elles ne s'entendrent pas bien	they don't get along well		
embarquer	to board (a plane)		
embaucher	to hire		
en	--- replaces any word introduced by de		
en automne	in autumn		
en class économie	in economy class (plane)		
en classe affaires	in business class		
en deuxième class	in second class (train)		
en espèces	cash		
en été	in summer		
en hiver	in winter		
en première class	in first class		
en section fumeur	in the smoking section		
en section non-fumeur	in the non-smoking section		
en voiture	by car		
enlève ta ceinture	take off your seatbelt		
enlever une tache	to remove a spot/stain		
énorme, miniscule	enormous, miniscule		
enregistrer	to check (luggage)		
ensuite	next, then		
entendu	understood?		
enverr	envoyer stem		
enverrai, enverras, enverra, enverrons, enverrez, enverront	conjugate envoyer in future		
envoyer	to send		
éplucher	to peel		
er verbs including aller	when do you drop the s for tu in commands		
éric écoute la radio en lavant sa voiture	eric listens to the radio while washing his car	deck#2	due@2021-10-25 19:08:13
espérer	to hope		
espères-tu qu'il fasse des grandes vacances	do you wish it were summer vacation?		
espères-tu que sa mère vienne	do you hope that his mother comes?		
est-ce qu'on dîne à la maison	are we having dinner at home? (informal)		
est-ce que paul me connait?	does paul know me		
est-ce que sophie leur parle	is sophie talking to them		
est-ce que tu es libre samedi	are you free saturday		
est-ce que tu te laves	do you wash yourself		
et avec ça?	and what else?		
étais, étais, était, étions, étiez, étaient	etre imparfait conjugations		
être cassé	to be broken		
étroit, large	narrow and wide (shoes)		
eut, eurent	avoir passe simple		
eux	stress pronoun for them		
évite des requins!	avoid the sharks!		
faire carrière	to have a career in		
faire de la voile	to sail		
faire du sport	to play sports		
faire du vélo	to go cycling		
faire du vtt	to go mountain biking		
faire la connaissance de	to get to known someone		
faire la vaisselle	to do the dishes		
faire le ménage	to clean up		
faire ses valises	to pack		
faire un pique-nique	to have a picnic		
faire un séjour a l'étranger	to spend some time abroad		
faire un tour à cheval	to go for a horseback ride		
faire un tour à pied	to go for a walk		
faire un tour à velo	to go for a bike ride		
faire une promenade	to go for a walk or ride		
faire une randonnée	to go for a hike, a long ride		
fais le plein avant de partir	fill up the tank before leaving		
faisais, faisais, faisait, faisions, faisiez, faisaient	faire imparfait conjugations		
faites attention!	pay attention!		
féliciter	to congratulate		
ferai, feras, fera, ferons, ferez, feront	conjugate faire in future		
fermer, éteindre	to turn off		
finis tes devoirs	finish your homework		
finis, finis, finit, finîmes, finîtes, finirent	conjugate finir in passe simple		
finis, finis, finit, finissons, finissez, finissent	conjugate finir in present		
finissais, finissais, finissait, finissions, finissiez, finissaient	finir imparfait conjugations		
first off	tout d'abord		
fit, firent	faire passe simple		
fonctionner, marcher	two ways to say to function		
fut, furent	etre passe simple		
gagner sa vie	to earn a living		
garde ta ceinture	keep your seat belt on		
gelé	frozen		
gentil, sympa	two ways to say nice		
grandir	to grow		
haut et bas	high and low		
heureux, content	two ways to say happy		
hier, j'ai couru cinq kilomètres	yesterday, i ran five kilometers		
hier, je t'ai aperçu au centre commercial	yesterday, i saw you at the mall		
hier, monique a dit qu'elle irait au café	yesterday, monique said that she went to the cafe (it's conditional bc monique is in the past but she's talking about the future)		
il a les cheveux en brosse	he has a crew cut		
il a pris sa retraite	he retired		
il a une barbe et une moustache	he has a beard and a mustache		
il a une queue de cheval	he has a ponytail		
il a vomi	he threw up		
il court premièrement	he runs first		
il est barbu	he is bearded		
il est chauve	he is bald		
il est cinq heures et demie	it's half past five		
il est costaud	he is masculinely muscular		
il est d'une humeur exécrable	he's in a foul mood		
il est dans le coffre	he's in the trunk		
il est en face de lui	he's across from him		
il est énervé	he's upset		
il est gros	he is fat		
il est important que nous soyons à l'heure	it is important that we we are on time		
il est malade	he's sick		
il est mon voisin	he's my neighbor		
il est petit	he is short		
il est timide	he's shy		
il est triste	he's sad		
il est trois heures et quart	it's a quarter past three		
il est une heure de l'après-midi	it's one o'clock in the afternoon		
il est utile de parler français	it is useful to speak french		
il était deux heures	it was two oclock		
il faisait beau	it was beautiful weather		
il fait beau, il fail bon	it's beautiful out, it's warm		
il fait chaud, il fait mauvais	it's hot, it's terrible out		
il fait frais, il pleut	it's cool out, it's raining		
il fait froid, il neige	it's cold, it's snowing		
il faut qu'ils sortent avant midi	they have to leave before noon		
il faut que je finisse mon travail	i have to finish my work		
il faut que je mette ma ceinture de sécurité	it is necessary that i fasten my seatbelt		
il faut que tu conduises	it is necessary that you drive well (remember you have to use the subjonctif for il faut!)		
il faut que tu répondres à ma question	you have to answer my question		
il faut que vous répariez la voiture	you have to fix the car		
il gagne de l'argent en lavant des voitures	he earns money washing cars		
il heurte un panneau	he crashes into a sign		
il le lui a rendu	he gave it back to her		
il leur a prêté son chien	he lent his dog to them		
il lui a demandé une bague	he asked for a ring from her		
il m'a choisi	he chose me	deck#2	due@2021-10-25 19:07:32
il m'a vendu une glace à l'eau	he sold me a popsicle		
il me faut un stylo à bille	i need a ballpoint pen		
Il n'a ni frères ni soeurs ni cousins	He has neither brothers nor sisters nor cousins		
il n'a rien mangé	he didn't eat anything		
Il n'aime aucun programme de télé-réalité	He likes no TV-reality show.		
il n'est jamais allé nulle part	he never went anywhere		
il n'était pas prudent	he wasn't careful		
Il n'y a nulle part où je préférerais être	There is nowhere where I would rather be.		
il n'y a plus de chiens	there aren't any more dogs		
il n'y en a pas	there aren't any apples (there aren't any)		
Il ne mange des pâtes que le samedi	He eats pasta only on Saturdays		
Il ne mange que des pâtes le samedi	He eats only pasta on Saturdays		
Il ne veut ni vin ni eau	He wants neither wine nor water		
Il ne veut plus venir avec nous	He doesn't want to come with us anymore		
il neigeait	il neige imparfait		
il pleuvait	il pleut imparfait		
il pleuvra	il pleut in future		
il s'est brûlé	he got burned		
il s'est rompé avec lui	he broke up with him		
il va y avoir un orage	there's going to be a thunderstorm		
il y a de la place	there's room, there's space		
il y a des vaches à la ferme	there are cows on the farm		
il y a dix jours	ten days ago		
il y a eu un orage	there was a thunderstorm		
il y a une mouche sur le pare-brise	there's a fly on the windshield		
il y aura	il y a in future		
il y avait	il y a imparfait		
il y en a une	il y a une papeterie dans mon quartier (redo with en)		
ils	subjonctif stem comes from what form		
ils essayent de fuir	they try to escape		
ils s'auriaient dû embrasser	they should have kissed		
ils se donnent rendez-vous	they agree to meet		
ils se retrouvent, ils se rencontrent	they meet each other (2 ways)		
ils sont maigres	they are skinny		
ils vendront leur maison	they will sell their house		
irai, iras, ira, irons, irez, iront	conjugate aller in future		
j'accepte de danser	i agree to dance		
j'ai acheté cette chemise-ci	i bought this here shirt		
j'ai amené ma copine à la fête	i brought my girlfriend to the party		
j'ai autant de cousins de toi	i have as many cousins as you		
j'ai cherché mon chien	i looked for my dog		
J'ai cherché partout, mais je ne l'ai trouvé nulle part	I looked everywhere, but I didn't find it anywhere.		
j'ai d'autre projets	i have other plans		
j'ai dit le secret à ta mère	i told the secret to your mom		
j'ai donné le livre à votre fille	i gave the book to your daughter		
j'ai envie d'un chien	i want a dog		
j'ai envie de mourir	i feel like dying, i want to die		
j'ai eu le coup de foudre pour toi	i fell in love at first sight with you		
j'ai faim et j'ai soif	im hungry and thirsty		
j'ai fait une piqûre	i got a shot		
j'ai mal au coeur	i feel nauseous		
j'ai mauvais rapport avec elle	i have a bad relationship with her		
j'ai oublié de utiliser les toilettes	i forgot to use the bathroom		
J'ai passé trois mois sur ce livre	I spent 3 months on that book		
j'ai perdu le clé	i lost the key		
j'ai prêté d'argent à paul	i lent money to paul		
j'ai rencontré ta copine	i ran into your girlfriend		
j'ai rendu visite à ma grand-mère	i visited my grandmother		
j'ai réparé mon vélo	i repaired my bike myself		
j'ai réservé une chambre à un lit pour deux personnes	i reserved a one-bed room for two people		
j'ai suivi un cours l'été dernier	i took a class last summer		
j'ai un rendez-vous à neuf heures	i have an appointment at nine		
j'ai vécu	i lived		
j'ai visité le canada	i visited canada		
j'ai vu pauline ce matin. je l'ai vue hier aussi	i saw pauline this morning. i saw her yesterday too		
j'aime bien des saucissons grands	i love big sausages		
j'aime le rosbif, je préfère la glace, et je déteste les frites	i like roast beef, i prefer ice cream, and i hate french fries		
j'allais souvent à la pêche	i often would go fishing		
j'apprend à parler français	im learning how to speak french		
j'apprends	im learning		
j'arrête de courir	i stop running		
j'aurais voulu dire la verité	i wish i had told the truth		
j'aurais voulu faire ta connaissance	i would have liked to get to know you		
j'avais voyagé	i had travelled		
j'en ai deux	j'ai deux cahiers (redo with en)		
j'en ai pris	j'ai pris des photos (pronoun form)		
j'en ai une	tu as une guitare? (respond in affirmative)		
j'espère que sa mère viendra	i hope his mother comes		
j'habite à paris	i live in paris		
j'habite à un kilomètre	i live a kilometer away		
j'habite tout près	i live nearby		
j'y ai répondu	j'ai répondu à cette lettre		
j'y suis passé	tu es passé chez lucien? (respond with y)		
jaune	yellow		
je commence à courir	i begin to run		
je connais la fille dont tu parles	je connais la fille. tu parles de cette fille		
je continue à courir	i continue to run		
je double la voiture	i pass the car		
je doute, il est douteux, il est possible, il est impossible utilisent le subjonctif	i doubt, it is doubtful, it is impossible, it is possible use subjunctive		
je finis de faire mes devoirs	i finish doing my homework		
je finis le repas	i finish the meal		
je gagne de l'argent en ayant une fille	i earn money while having a daughter		
je gagne de l'argent en êtant contente	i earn money being happy		
je gagne de l'argent en sachant des des faits	i earn money knowing facts		
je hésite à manger ta nourriture	i hesitate to eat your food		
je joue au tennis	i play tennis		
je joue de l'hautbois	i play the oboe		
je l'ai cru	i believed it		
je l'ai pris	i took my moped (replace w pronouns)		
je l'ai prise	i took my guitar (ma guitare) (replace w pronouns)		
je les ai prises	j'ai pris tes photos		
je les invite	i invite them		
je lui ai donné rendez-vous	i made a date with him		
je lui ai téléphoné	i called her		
je m'en plains	i complain about it		
je mange du yaourt et des céréales pour le petit déjeuner	i eat yogurt and cereal for breakfast		
je me lève à sept heures	i get up at seven o clock		
je me porte bien, je suis bien portante	i'm in good health		
je me sens bien	i feel fine		
je me suis couchée tard	i went to bed late		
je me suis foulé la cheville	i broke my ankle		
je me suis perdue et j'ai été piqué par un moustique	i got lost and got stung by a mosquito		
je me suis présenté en retard	i showed up late		
je me suis réveillée tôt	i woke up early		
je mesure un mètre soixante-trois	i'm five feet four inches tall		
je n'achète qu'un cahier	i only buy one notebook		
Je n'ai aucune idée	I have no idea!		
je n'ai pas le temps de jouer au tennis	i don't have time to play tennis		
je n'ai pas organizé un boum	i didn't organize a party		
je n'ai pris aucun	i didn't take any		
je n'ai pris aucune	i didn't take any (cars)		due@2021-10-24 19:08:03
je n'ai rien fait hier	i didn't do anything yesterday		
je n'ai rien vu	i didn't see anything		
je n'ai vu mathieu nulle part	i didn't see mathieu anywhere		
je n'ai vu personne	i didn't see anyone		
Je n'aime ni le fromage ni le lait	I like neither cheese nor milk.		
je n'aime pas tellement le gâteau	i don't like cake very much		
je n'en ai pas acheté	i didn't buy bread (i didn't buy some)		
je n'espère pas que sa mère vienne	i don't hope his mother comes		
je ne comprends pas ce dont tu parles	i don't understand that thing that you are talking about		
je ne comprends pas ce que tu dis	i don't understand the thing that you are saying		
je ne comprends pas ce qui se passe	i don't understand the thing that is happening		
je ne cours presque jamais	i almost never run		
je ne fais pas réparer mon portable	i didn't get my phone fixed		
je ne leur ai pas écrit	je n'ai pas écrit à mes cousins		
je ne mange que des légumes	i only eat some vegetables		
je ne me lave pas	i don't wash myself		
je ne me souviens pas de m'être promené dans ce park	i don't remember taking a walk in ce park		
je ne me suis pas encore brossé les dents	i didn't brush my teeth yet		
je ne regrette rien	i regret nothing		
je ne sais rien	i know nothing		
je ne sors avec personne	i didn't go out with anyone		
je ne suis allé nulle part	i didn't eat any part		due@2021-10-24 19:09:54
je ne suis allée nulle part	i didn't go anywhere		
Je ne veux ni chanter ni danser	I neither want to sing nor dance.		
je parle lentement	i walk slowly		
je parle vite	i talk quickly		
je pense à eux	i'm thinking about them		
je pense que c'est vrai, je trouve que c'est vrai, je crois que c'est vrai	i think that's true		
je pèse quarante-huit kilos.	i weigh 48 kilos		
je pleure longtemps	i cry for a long time		
je porte des lunettes	i wear glasses		
je porte des verres(lentilles) de contact	i wear contact lenses		
je porte du 38	i wear size 38		
je préfère celle qui est en solde	i prefer the one that's on sale		
je préfère celui-ci	i prefer this one		
je prenais le métro tous les soirs	i used to take the subway every evening		
je prends des médicaments le matin et le soir, toutes les douze heures	i take my medicine in the morning and evening, every twelve hours		
je réussis à manger	i succeed in eating		due@2021-10-24 19:06:43
je rêve de faire l'amour	i dream about making love		
je reviens des états-unis	i come back to the united states		
je suis américaine	i am american		
je suis blessé	im hurt		
je suis content d'aller au café	i am happy to do to the cafe		
je suis contente qu'elle se soit amusée	i am happy that she had fun		
je suis contente que tu aies parlé avec marie, et je suis heureuse que tu l'aies invitée à la boum	i am happy that you spoke with marie, and i am happy that you invited her to the party		
je suis de taille moyenne	i am average height		
je suis des états-unis	i am from america		
je suis descendue du train	i got off the train		
je suis en bonne santé	i am in good health		
je suis en forme	i am in shape, im healthy		
je suis fière, il est fier	im proud		
je suis furieuse	i am furious		
je suis perplexe	im perplexed		
je t'ai entendu quand tu l'as dit	i heard you when you said it		
je t'en prie	you're welcome		
je te plains	i feel sorry for you		
je traversais la rue	i was crossing the street		
je vais au café pour rencontrer les copains	i go to the cafe to meet the friends		
je vais déjeuner à la cantine	i'm going to have lunch in the school cafeteria		
je vais en acheter deux	je vais acheter deux cahiers (redo with en)		
je vais éternuer	im going to sneeze!		
je vais le regarder	i will watch it		
je vais me raser avec un rasoir	i will shave myself with a rasor		
Je vais passer te voir demain.	I'll come (by to) see you tomorrow.		
je vais réfléchir	i'll think it over		
je vais y aller	tu vas aller au cinéma ce soir (respond with y)		
je veux bien que tu sortes	i want very much for you to leave		
je veux que tu ailles au supermarché	i want you to go to the supermarket		
je veux que tu sortes avec moi	i want you to go out with me		
je veux que tu sortes avec moi	i want you to go out with me		
je viens de la papeterie	i am coming from the stationary store		
je voudrais	i would like		
je voudrais bien, mais	i'd like to, but...		
je voudrais que tu sois ici	i would like you to be here		
je voudrais te parler	i would like to speak to you		
je vous téléphonerai avant que vous partiez	i will call you before you leave		
je voyagerai en italie	i will travel to italy		
jérôme parle toujours de lui-même	jerome always talks about himself		
jeter des déchets	to throw out trash		
jeudi	thursday		
jouer à, participer à, croire à, penser à, assister à, faire attention à	6 words that are used with à		
jusqu'à quand	until when		
l'acier	steel		
l'addition	the check, the bill		
l'après-rasage	the aftershave		
l'article	the item		
l'avion a décollé	the plane took off		
l'avion est complet	the plane is full		
l'avion n'a jamais décollé	the plane never landed		
l'eau de toilette	the body spray		
l'élevage	farming (animals)		
l'équitation	the horseback riding		
l'escalade	rock climbing		
l'étoffe	fabric		
l'eye-liner	the eyeliner		
l'hexagone	la france s'appelle		
l'homme est dehors	the man is outside		
l'hôtesse de l'air	stewardess		
l'infirmier va lui faire un plâtre et il va lui donner des béquilles	the nurse will put a cast on him and give crutches to him		
l'oncle	the uncle		
l'or	the gold		
la batterie	the drums		
la boîte est devant la porte	the box is in front of the door		
la caoutchouc	rubber		
la ceinture de sécurité	seat belt		
la colline	the hill		
la comptabilité	accounting		
la consigne	the baggage-check		
la crème à raser	the shaving cream		
la femme	the wife		
la fourrure	the fur		
la france est le premier pays d'europe pour la --- de son territoire	grandeur		
la gérante	the manager		due@2021-10-24 19:06:50
la gestion	management		
la gym	gymnastiques		
la joue	the cheek		
la lentille	the len		
la machine avec laquelle je travaille	the machine with which i work		
la marche à pied	hiking		
la mer	the shore, the ocean		
la note	the bill		
la papeterie	office/school supply/stationary shore		
la pension complète	full room and board		
la personne avec qui je travaille	the person with whom i work		
la porte	the gate (airport)		
la poste	the post office		
la prise	the plug		
la quantité	the quantity		
la robe rose est plus belle que la robe noire	the pink dress is prettier than the black dress		
la roue	the wheel		
la roue	the wheel		
la rougeole, les oreillons, la varicelle, la rubéole, la coqueluche	des maladies d'enfance (5)		
la salle d'attente	the waiting room		
la semaine dernière	last week		
la soeur	the sister		
la soie	the silk		
la sortie	the exit		
la tante	the aunt		
la toile	the linen		
la vérité	the truth		
laissez-les-moi longs	leave it long (hair)		
lave-toi	wash yourself		
laver le linge	to do the laundry		
le balcon a une belle vue	the balcony has a beautiful view		
le basket	basketball		
le bébé a des boutons	the baby has a rash		
le billet de métro	a subway ticket		
le blé	the wheat		due@2021-10-24 19:07:57
le bois	wood		
le bouton	the button		
le café	coffee		
le carton	cardboard		
le chapeau marron est aussi beau que le chapeau jaune	the brown hat is just as pretty as the yellow hat		
le cinquième	the fifth		
le climat méditerranéen est	chaud et ensoleillé		
le coeur	the heart		
le comptoir	the counter		
le conducteur était un témoin	the driver was a witness		
le corps	the body		
le cou	the neck		
le cou	the neck		
le courrier	the mail		
le cousin, la cousine	the cousin		
le cuivre	copper		
le déodorant	the deodorant		
le dessin	design		
le deuxième	the second	deck#2	due@2021-10-25 19:10:17
le droit	law		
le fard à paupières	the eyeshadow		
le fer	iron		
le fils	the son		
le fleuve qui sépare la france de l'allemagne	le rhin		
le foot	soccer		
le frein	the brake		
le front	the forehead		
le gant de toilette	the wash cloth (really a wash glove in france)		
le garçon dont je te parle	the boy that i tell you about		
le guichet	the ticket window		
le jogging	the jogging		
le jus de pomme	the apple juice		
le klaxon est bruyant, il est fort	the horn is loud		
le la les	me te nous vous before		
le lundi	every monday		
le manteau pure laine est moins beau que le manteau en coton	the wool coat is less pretty than the cotton coat		
le mari	the husband		
le médecin a fait un radio	the doctor took an x ray		
le médecin me donne une ordonnance	the doctor gives me a perscription		
le médecin me soigne	the doctor treats me		
le menton	the chin		
le météo prédit du beau temps, du soleil, et un ciel bleu	the weather forecast predicts good weather, sun, and blue skies		
le micro	the microphone		
le patin à roulettes	rollerskating		
le patinage	skating		
le paysage en beauce	des grandes plaines		
le perfum	the perfume		
le pierre	stone		
le pilote	the pilot		
le plomb	lead		
le pneu est à plat	the tire is flat		
le poids	weight		
le pouboire	the tip/service charge		
le premier	the first (masc)		
le prof explique pour que vous compreniez	the teacher explains so that you understand		
le quai	the platform		
le quatrième	the fourth		
le rimmel	the mascara		
le roller	in-line skating		
le samedi soir, nous allions au cinéma	every saturday evening, we went to the movies		
le séchoir	the hair dryer		
le service dans les chambres	room service		
le skate	skateboarding		
le snowboard	the snowboard		
le sol	the soil		
le soutien	the support		
le steward	the steward		
le surf	surfing		
le surf des neiges	snowboarding		
le tableau d'affichage	the billboard		
le tennis	tennis		
le thon est un poisson	tuna is a fish		
le tissu	the fabric		
le tonnerre	thunder		
le troisième	the third		
le velours	the velvet		
le velours côtelé	corduroy		
le vernis à ongles	the nail polish		
le vol	the flight		
le vol était annulée	the flight was cancelled		
le volant	the steering wheel		
lea, tu me le prêtes?	lea, did you lend it to me?	deck#2	due@2021-10-25 19:06:56
Les alliés ont débarqué en Normandie.	the allies landed in normandie		
les ciseaux	scissors		
les dames	the checkers		
les échecs	the chess		
les feuilles sont vertes en été	the leaves are green in summer		
les forêts	the forests		
les freins	the brakes		
les gens dansaient	the people were dancing		
les grands-parents	the grandparents		
les horaires	the schedules		
les jeux d'ordinateur	the computer games		
les jeux vidéos	the video games		
les livres sont à côté de la chaise	the books are next to the chair		
les montagnes à l'est	les vosges		
les montagnes au sud-est	les alpes		
les montagnes au sud-ouest	les pyrénées		
les parents	parents/relatives		
les pays qui entourent la france sont	l'espagne, l'italie, la suisse, l'allemagne, le luxembourg, la belgique		
les traveau domestiques	household chores		
les voyages	trips		
lesquelles voulez-vous essayer	which ones do you want to try (shoes?)		
leur	their		
lève la main	raise your hand		
lingerie	laundry room		
lisais, lisais, lisait, lisions, lisiez, lisaient	lire imparfait conjugations		
loger, séjourner	to stay (2 words)		
long, longue	long		
lorsque, quand	2 ways to say when		
louer une voiture	to rent a care		
lourd, léger	heavy, light		
lui	stress pronoun for her/him		
lui leur	le la les before		
lui, leur	used when you say à quelqu'un		
ma maison se trouve au bout de la rue	my house is located at the end of the street		
ma montre était chère	my watch was expensive		
ma soeur n'aime personne	my sister doesn't like anyone		
malheureux	unhappy		
mangeais, mangeais, mangeait, mangions, mangiez, mangeaient	manger imparfait conjugations	deck#2	due@2021-10-25 19:07:18
marc a vu nicole et sylvie? oui, il les a vues.	did marc see nicole and sylvie? yes, he saw them		
me le lui en	order: lui le me en		
meilleur	better		
mercredi	wednesday		
mets le couvert	set the table		
mets ta ceinture	put your seatbelt on		
mettre	to put, to put on		
mille	one thousand		
mince et épais	thin and thick		
moche	ugly		
monte les valises	bring the suitcases up		
monter	to get on		
montrez-moi ton saucisson	show your sausage to me		
movie stars	les vedettes de cinéma		
n'achète pas cette casquette	don't buy this cap		
naître	to be born		
ne fais pas peur aux animaux	don't scare the animals		
ne glisse pas	don't slip		
ne me coupex pas trop courts	don't cut it too short		
ne me klaxonne pas!	don't honk at me		
ne mets pas le feu quand tu feras un tour dans les bois	don't set a fire when you walk in the woods		
ne pars pas sans mettre ta ceinture de sécurité	don't leave without putting on your seatbelt		
ne t'en fais pas	don't worry		
ne te lave pas	don't wash yourself		
ne te repose pas	don't rest!		
nettoie ta chambre	clean your room		
nous avons besoin d'aller à la station-service	we need to go to the gas station		
nous avons fait un match	we played a game		
nous avons lu un livre	we read a book		
nous avons peur qu'elle soit malade	we are afraid that she is sick		
nous en avons visité plusieurs	nous avons visité plusiers monuments (redo in pronoun form)		
nous faisons le plein	we fill it up with gas		
nous ferons une promenade à vélo à condition qu'il fasse beau	we will have a bike ride on the condition that it's nice out		
nous le craignons	we fear him		
nous montons dans le train	we get on the train		
Nous n'avons acheté aucune voiture	We bought no car.		
nous ne sommes pas encore mariés	we aren't married yet		
nous nous réjouissons	we are happy		
nous nous sommes retrouvés à l'école	we met at school		
nous prenons un pot	we have something to drink in the cafe		
nous sommes espagnoles	we're spanish		
nous sommes fatigués	we're tired		
nous sommes forts	we are strong		
Nous sommes passés devant la porte à midi.	We passed by the door at noon		
nous sommes tristes de partir	we are sad to leave		
on en a acheté	we bought some croissants		due@2021-10-24 19:10:01
on peut trouver un climat continental à ---, avec des --- et des ---	l'est, hivers froids, étés chauds		
on y va?	should we go? are we going?		
ondulé	wavy		
où est-ce que tu as mal	where does it hurt		
où travaille-t-il	where is he working		
où vas-tu	where are you going		
oui, je les lui ai montrés	yes, i showed them to him		
oui, montre-la-lui	yes, i showed the photo to her (use pronouns)	deck#2	due@2021-10-25 19:09:15
overcast	couvert		
owing to	du fait de		
paierai, paieras, paiera, paierons, paierez, paieront	conjugate payer in future		
paierai, paieras, paiera, paierons, paierez, paieront	payer in future		
par an	a year, per year		
par chèque	by check		
par mois	a month, per month		
par semaine	a week, per week	deck#2	due@2021-10-25 19:09:28
parlai, parlas, parla, parlâmes, parlâtes, parlèrent	conjugate parler in passe simple		
parler à	to speak/talk to		
parlerai, parleras, parlera, parlerons, parlerez, parleront	conjugate parler in future		
parlerais, parlerais, parlerait, parlerions, parleriez, parleraient	conjugate parler in conditionnel		
parlerais, parlerais, parlerait, parlerions, parleriez, parleraient	conjugate parler in the conditionnel		
parlez-en	speak of something		
partir	to leave		
pas du tout	not at all		
passe la nuit avec moi	spend the night with me		
passer	to stay		
passer l'aspirateur	to vacuum		
patiemment	patiently		
paul gagne de l'argent en lavant des voitures	paul makes money washing cars		
pauvre	poor		
personne	no one		
personne n'a téléphoné	no body telephoned		
philippe et claire se téléphonent	philippe and claire telephone each other		
pierre dit que le film est génial	pierre says that the movie is great		
pierre est ici, il est là, il est à la maison, il est au restaurant, il est à paris, il est en classe, il est en france, il est en vacance, il est en ville	pierre is here, pierre is there, pierre is at home, pierre is at the restaurant, pierre is in paris, pierre is in class, pierre is in france, pierre is on vacation, pierre is in town		
plat	flat		
plus	Bette m'a dit que tu fumes encore!		
Tex: Mais non! Je ne fume ____________.			
plusieurs fois	several times		
pointu	pointed		
poli	polished		
pourr	pouvoir stem		
pourrai, pourras, pourra, pourrons, pourrez, pourront	conjugate pouvoir in future		
Pouvez-vous passer acheter du pain ?	Can you go buy some bread?		
préfère, préfères, préfère, préférons, préférez, préfèrent	conjugate preferer in present		
préfère, souhaite, désire, voudrais, aimerais, veux, insiste, exige	je --- and you gotta use subjonctif		
préférer	to prefer		
prendre	to take		
prendre un bain de soleil	to sunbathe		
préoccupé, inquiet	two words for worried		
présenter	to present, to show		
prit, prirent	prendre passe simple		
privilégié	privileged		
propre	clean		
q'est-ce qu'il y a	what's wrong		
qu'est-ce qu'il y a	what is it		
qu'est-ce que c'est, ta pointure	what's your shoe size		
qu'est-ce que tu as	what's the matter		
qu'est-ce que tu vas faire	what are you going to do		
qu'est-ce que tu vas faire après avoir fini tes études	what will you do after having finished your studies		
qu'est-ce que tu veux	what do you want		
qu'est-ce qui est arrivé	what happened		
qu'est-ce qui ne marche pas	what's wrong		due@2021-10-24 19:10:14
quand j'aurai de l'argent, je voyagerai	when i have the money, i will travel		
quand j'étais jeune, nous habitions à la campagne	when i was young we lived in the country		
quand nous sommes arrivés à la gare, le train était parti	when we arrived at the train station, the train had left		
quatorze, quinze, seize	14, 15, 16		
quatre-vingt-dix-huit	98		
quatre-vingt-onze	91		
quatre-vingt-un	81		
quel âge a-t-il	how old is he		
quel est le prix de ce manteau	what is the price of the coat		
quel est le problème	what is the problem		
quel jour est-ce	what day is it		
quelle heure est-il	what time is it		
quelle sorte	what kind		
quelle veste préfères-tu? celle-ci ou celle-là	which jacket do you want, this one or that one?		
quelles filles	which girls?		
quelques-unes sont venues	quelques amies sont venues (redo in pronoun form)		
qui est cette fille? c'est celle qui parle espagnol	who's this girl? it's the one who speaks spanish		
raconte à moi	tell me what happened		
ralentissez	slow down		
rangé, en désordre	picked up, in disorder		
recevr	recevoir stem		
recevrai, recevras, recevra, recevrons, recevrez, recevront	conjugate recevoir in future		
reconnaître	to recognize		
reçut, reçurent	recevoir passe simple		
regretter	to be sorry		
rendre service à quelqu'un	to do a favor for someone		
renseignements	information		
réparer	to fix		
repasser	to iron		
répondis, répondis, répondit, répondîmes, répondîtes, répondirent	conjugate repondre in passe simple		
répondre à	to answer		
repose-toi!	rest!		
ressentir	to feel (a noun)		
retrouver	to retreive (find, rediscover)		
reviendr	revenir stem		
riche	rich		
rien n'est impossible	nothing is impossible		
roger a le plus de devoirs de tous	roger has the most homework of all		
rose	pink		
rouge	red		
roux or rousse	redheaded		
rugueux, lisse	rough, smooth		
s'amuser	to have fun		
s'arrêter	to stop		
s'embêter	to get bored		
s'en aller	to go away	deck#2	due@2021-10-25 19:08:23
s'essuyer les mains	to wipe dry one's hands (you can also use this verb to wipe dry other things)		
s'excuser	to apologize		
s'il avait eu faim, il aurait mangé avec nous	if he had been hungry, he would have eaten with us		
s'il te plaît, donne-moi une pomme	please, give me an apple (informal)		
s'il vous plaît, donnez-moi un coca	please, give me a coke (formal)		
s'impatienter	to get impatient		
s'inquiéter	to worry		
s'occuper de	to be busy with/to take care of		
s'occuper des animaux	to take care of the animals		
sa copine l'attendait	her friend was waiting for her		
sac à dos	a backpack		
sale	dirty		
samedi	saturday		
samedi dernier, nous sommes allées au concert	last saturday, we went to the concert		
saur	savoir stem		
saurai, sauras, saura, saurons, saurez, sauront	conjugate savoir in future		
se couper les ongles	to cut your nails		
se disputer	to have an argument		
se faire un shampooing	to get a wash and cut		
se laver les cheveux	to wash your hair		
se mettre à table	to sit down to eat		
se mettre en colère	to get angry		
se rappeler, se souvenir de	to remember, to recall		
se sécher les cheveux	to dry your hair		
se sentir	to feel (adjective or expression)		
se spécialiser	to major in		
se tromper	to make a mistake		due@2021-10-24 19:08:29
se trouver	to be located		
sec, sèche, mouillé	dry (masc, fem) and wet		
sécateur	shrub clippers		
sembler	to seem		
sentir	to smell (something or of something)		
serai, seras, sera, serons, serez, seront	conjugate etre in future		
serais, serais, serait, serions, seriez, seraient	conjugate etre in conditionnel		
si + imparfait	use this conjugation for a wish or to make a suggestion		
si j'ai de l'argent, je voyagerai	if i have the money i will travel		
si j'avais etudié, j'aurais réussi à l'examen	if i had studied, i would have passed the exam		
si j'étais en france, je parlerais français	if i were in france, i would speak french		
si j'étais riche, je voyagerais tout le temps	if i were rich, i would travel all the time		
si je gagnais à la loterie, j'achèterais une moto	if i won the lottery, i would buy a motorcycle		
si nécessaire, elles vendraient leur voiture	if necessary, they would sell their car		
si on allait au cinéma	should we go to the movies?		
si tu avais le temps, tu finirais ta leçon	if you had the time, you would finish your lesson		
si tu étais au lycée à paris, tu parlerais français en classe	if you were at school in paris, you would speak french in class		
si tu vas en ville, tu rentreras tard	if you go downtown, you will come home late		
soixante	60		
soixante-dix-sept	77		
soixante-onze	70		
solide et fragile	solid and fragile		
solliciter une entrevue, un entretien	to ask for an interview		
sortais, sortais, sortait, sortions, sortiez, sortaient	sortir imparfait conjugations		
sortir	to go out		
souffler	to blow		
sur le dessus	on top		
sur le devant	on the front		
sur les côtés	on the sides		
tailler l'arbuste	to prune the bush		
tais-toi, taisez-vous	be quiet, formal and informal		
téléphoner à	to call		
thanks to	grâce à		
the countryside	la campange		
the mountain range	le massif montagneux		
the surface area	la superficie		
to read the classified ads	lire les announces		due@2021-10-24 19:07:40
tomber	to come down		
tondre la pelouse	to mow the lawn		due@2021-10-24 19:06:48
tourism	le tourisme		
tourner	to turn		
tous les jours j'allais à l'école	every day i went to school		
tout le monde	everyone		
transporter	to carry		
travailler	to work		
trouver	to find		
tu achètes cette chemise-là	you buy that shirt there		
tu as attrapé un coup de soleil	you got a sunburn		
tu as cessé de fumer hier	you quit smoking yesterday		
tu as raté le tren	you missed the train		
tu as un rhume, tu es enrhumé	two ways to say you have a cold		
tu as une cicatrice	you have a scar	deck#2	due@2021-10-25 19:09:33
Tu as une soeur? Aucune!	Do you have a sister? None!		
tu aurais pu gagner	you could have won		
tu es d'accord avec moi	do you agree with me		
tu es de bonne humeur	you're in a good mood		
tu es décontractée	you're relaxed		
tu es faible	you're weak		
tu es inutile	you're useless		
tu es pénible	you're a pain		
tu es sûr	are you sure		
tu finiras ta leçon	you will finish your lesson		
tu invites sylvie? oui, invite-la. non, ne l'invite pas	i invite sylvie? yes, invite her. no, don't invite her		
tu la vois	you saw the girl over there (redo w pronouns)		
tu m'as emprunté d'argent	you borrowed money from me		due@2021-10-24 19:08:35
tu n'as pas invitée marianne. à ta place, je l'aurais invitée	you didn't invite marianne. if i were you, i would have invited her		
Tu ne comprends plus cette leçon	You do not understand this lesson anymore		
tu plaisantes!	you're kidding		
tu saignes du nez	you have a nosebleed		
tu y joues	you play soccer (you play it?)		
un accident a eu lieu	an accident took place	deck#2	due@2021-10-25 19:08:44
un acteur, une actrice	an actor, an actress		
un agent de change	a stockbroker		
un agent immobilier	a real estate agent		
un aller et retour	a round-trip ticket		
un aller simple	a one way ticket		
un appareil	an appliance		
un appareil-photo	a camera		
un arbre	a tree		
un assistante social	a social worker		
un bagage à main	a carry on bag		
un balai	a broom		
un bloc	a pad (for writing)		
un camarade	a classmate		
un cambriolage	a burglary		
un canard	a duck		
un carie, un plomage, une dent de sagesse	a cavity, a filling, a wisdom tooth		
un carnet	a notebook		
un CD-ROM, un cédérom	two ways to spell a CD		
un champ	a field		
un chanteur, une chanteuse	a singer, masc and fem		
un chocolat	a hot chocolate		
un clavier	a keyboard		
un cochon	a pig		
un comptable	an accountant		
un concert	a concert		
un coton-tige	a cotton swab		
un couverture	a blanket		
un dessin animé	a cartoon	deck#2	due@2021-10-25 19:07:53
un doigt	a finger		
un drame psychologique	a psychological drama		
un drap	a sheet		
un écran	a screen		
un écureuil	a squirrel		
un élastique	a rubber band		
un endroit	a place		
un enfant, une enfant	the child		
un épingle de sûreté	a safety pin		due@2021-10-24 19:09:57
un éponge	a sponge		
un estomac	a stomach		
un événement	an event		
un fait	a fact		
un fer à repasser	an iron		
un film	a movie		
un film d'aventures	an action movie		
un film d'horreur	a horror movie		
un film de science-fiction	a science fiction movie		
un film policier	a detective movie		
un fleur	a flower		
un four	an oven		
un fruit, des haricots verts, des légumes, un pamplemousse, des petits pois, une banane, une carotte, une cerise, une fraise, une orange, une poire, une pomme, une pomme de terre, une salade, une tomate	fruit, green beans, vegetables, a grapefruit, peas, a banana, a carrot, a cherry, a strawberry, a orange, a pear, an apple, a potato, a head of lettuce, a tomato		
un garage	a garage		
un genre	a type, kind		
un groupe	a group		
un hôpital	a hospital		
un incendie	a fire		
un infirmier	a nurse		
un jogging	a jogging suit		
un joueur, une joueuse	a player, masc and fem		
un journal	newspaper, diary, or journal		
un lac	a lake		
un lapin	a rabbit		
un magazine	a magazine		
un match	a game		
un médecin	doctor (only masc)		
un mesonge	a lie		
un million	one million		
un mouchoir en papier	a tissue		
un musée	a museum		
un orage ou un ouragan	a thunderstorm or a hurricane		
un orchestre	a band/orchestra		
un oreiller	a pillow		
un pansement adhésif	a bandaid		
un pantalon	pants		
un passeport	a passport		
un permis de conduire	driver's license		
un pique-nique	a picnic		
un poisson	a fish		
un portemanteau, un cintre	a clothes hanger		
un réchaud	a camping stove		
un roman	a novel		
un rouleau	a roll		
un sac de couchage	a sleeping bag		
un short	shorts		
un siège	a seat		
un stage	an internship		
un supermarché	a supermarket		
un sweat	a sweatshirt		
un tee-shirt	a t-shirt		
un thé	a tea		
un théâtre	a theatre		
un train	a train		
un tube	a tube		
un tuyau d'arrosage	a garden hose		
un vol direct	a direct flight		
un week-end	a weekend		
une	en also replaces any word introduced by		
une adresse	an address	deck#2	due@2021-10-25 19:07:34
une allumette	a match		
une ambulance est arrivée	an ambulance arrived		
une auberge de jeunesse	a youth hostel		
une bague, un bijou, des boucles d'oreilles, une chaîne, un collier, une médaille	a ring, a piece of jewelry, earrings, a chain, a necklace, a medal		
une bande dessinée	comic strip		
une bibliothèque	a library		
une boîte	a box		
une bonne formation générale	a good education		
une boum, une fête, une soirée	three ways to say a party		
une boutique de soldes	a discount shop		
une cadre	an executive		
une caravane	a camping trailer		
une carte	a card		
une carte d'identité	an ID		
une carte postal	a postcard		
une caserne de pompiers	a fire station		
une casquette	a baseball cap		
une casserole	a pot		
une chanson	a song		
une chemise	a shirt		
une chercheuse	a researcher		
une chirurgienne	a surgeon		
une comédie	a comedy		
une comédie musicale	a musical		
une correspondence	a plane change		
une coupe de cheveux	a haircut		
une coupe-brushing	a haircut and blow-dry		
une cravate	a tie		
une dent	a tooth		
une épingle	a pin		
une équipe	a team		
une escale	a plane stopover		
une exposition	an exhibit		
une femme d'affaires	a businesswoman		
une fois	one time		
une fonctionnaire	civil servant		
une gendarmerie	a police station		
une histoire	a story		
une informaticienne	a computer specialist		
une jupe	a skirt		
une lampe	a lamp		
une lampe de poche	a flashlight		
une lettre	a letter		
une patronne	a boss		
une pellicule en noir et blanc	a black and white film		
une pellicule-couleurs	the color film		
une permanente	a perm		
une photo	photo		
une pièce de théâtre	a play		
une pile	a battery		
une piscine	a pool		
une place	a seat		
une plante	a plant		
une poêle	a pan		
une poème	a poem		
une poule	a hen		
une prairie	a prairie		
une rivière	a river		
une salle d'exercices	a gym		
une scientifique	a scientist		
une séance	a show/showing		
une société	a company		
une sorte	a kind, sort		
une table	a table		
une tondeuse	a lawn mower		
une tranche	a slice		
une usine	a factory		
une vache	a cow		
une valise	a suitcase		
une veste	a jacket		
une ville	a city		
uni	solid (colored clothing)		
usagé	worn		
usé	worn out		
va-t-en, allez-vous-en	go away, formal and informal		
vas-y	go ahead, go for it!		
vendais, vendais, vendait, vendions, vendiez, vendaient	vendre imparfait conjugations		
vendredi	friday		
venir	to come		
venir de, parler de, avoir besoin de, avoir envie de, avoir peur de	5 words that use de		
verrai, verras, verra, verrons, verrez, verront	conjugate voir in future		
vers	at about (time)		
vert, verte	green, masc and fem		
victor est venu avant que vous alliez en vacances	victor came before you go on vacation		
victor est venu sans que vous ayez rendez-vous	victor came without you having an appointment		
vide la corbeille, les ordures, la poubelle	empty the trash (3)		
vide, plein	empty, full		
viendr	venir stem		
viendrai, viendras, viendra, viendrons, viendrez, viendront	conjugate venir in future		
Viens dîner et amène ton amie avec toi	come to have dinner and bring your girlfriend with you		
vieux, vieille	old		
vint, vinrent	venir passe simple		
visiter la grèce	to visit greece		
vit, virent	voir passe simple		
voilà le café dont lucien nous a parlé	here's the cafe that lucien talks to us about		
voir	to see		
votre monnaie	your change		
voudr	vouloir stem		
voudrai, voudras, voudra, voudrons, voudrez, voudront	conjugate vouloir in future		
vous avez un grain de beauté	you have a beauty mark (formal)		
vous désirez?	may i help you		
vous désirez? et comme dessert?	what would you like? and for dessert		
vous êtes calme	you are calm (formal)		
vous êtes intéressant(e) et intelligent(e)	you are interesting and intelligent		
vous faites l'affaire	you are qualified		
vous les avez craint	you feared them		
vous vous êtes cassé le bras	you broke your arm		
voyager	to travel		
voyais, voyais, voyait, voyions, voyiez, voyaient	voir imparfait endings		
vraiment	really		
Where are you going? - Nowhere, why?	Where are you going? - Nowhere, why?		
zéro	zero		
#--decks immediate,daily,weekly,monthly,quarterly,yearly
#--intervals 0,1440,10080,43200,129600,518400
#--columns column#1,column#2
#--showcolumns column#1
#--showcolumns column#2
