Klimaanlage      air conditioning			due@2021-10-08 22:33:52
(Atom)kraft (f)	(nuclear) energy		
(Bürger)krieg (m)	(civil) war		due@2021-10-08 22:33:43
(Sport)bericht (m)	(sports) report		
(un)trinkbar	(not) drinkable		
(Wald)brand (m)	(forest) fire		
abbiegen	to turn (off)		
Abendessen (n)	evening meal, supper		
aber	but		
Abfahrt (f)	departure		
Abfall (m)	rubbish		
abfliegen	to depart (by plane)		due@2021-10-08 22:32:55
Abflug (m)	departure (by plane)		
Abitur (n)	equivalent to GCE A levels		
abnehmen	to lose weight		
Abreise (f)	departure		
abreisen	to depart		
abschicken	to send, to post		
abschicken	to send, to post		
Abschlussprüfung (f)	final exam		
abschreiben	to copy		
abspülen	to wash up		due@2021-10-08 22:35:01
Abteilung (f)	department		
abwählen	to drop (a subject)		
abwaschen	to wash up		
acht	eight		
achtzehn	eighteen		
achtzig	eighty		
adoptiert	adopted		
Adresse (f)	address		
ähnlich	similar		
Akrobat/in (m/f)	acrobat		
Aktivität (f)	activity		
Alkohol (m)	alcohol		
alle	everything		
allein	alone		
alles Gute	all the best		
allgemein	general, common		
alt	old		
alt	old		
alt, älter, ältest	old, older, oldest		
am, auf	on, at the		
amüsieren (sich)	to enjoy oneself		
Ananas (f)	pineapple		
anfangen	to begin, start		
anfangen	to begin, start		
anfangen	to begin, start		
angeln	to fish		
angeln	to go fishing		due@2021-10-08 22:40:20
Angelrute (f)	fishing rod	deck#2	due@2021-10-03 03:40:34
angenehm	pleasant		
angenehm	pleasant, nice, kind		
Angestellte(r) (f/m)	employee	deck#2	due@2021-10-03 02:25:52
Angriff (m)	attack		
Angst haben	to be afraid		
Anhänger (m)	pendant (jewellery)		
ankommen	to arrive		
Ankunft (f)	arrival		
Anrufbeantworter (m)	answerphone, voicemail	deck#2	due@2021-10-03 02:23:37
anrufen	to call (on the phone)		
anrufen	to ring, to phone, to give a call		
anschauen	to watch, look at		due@2021-10-08 22:33:37
Ansichtskarte (f)	picture postcard		
anstrengend	tiring		
anziehen (sich)	to get dressed		
Apfel (m)	apple		
Apfelsine (f)	orange	deck#2	due@2021-10-03 03:41:08
Apfelwein (m)	cider		
Apotheke (f)	chemist's (dispensing)		
Aprikose (f)	apricot		
Arbeit (f)	work		
arbeiten	to work		
arbeiten	to work		
arbeiten	to work		due@2021-10-08 22:37:24
Arbeiternehmer/in (m/f)	employee, worker		
Arbeitgeber/in (m/f)	employer		
arbeitslos	unemployed		
arbeitslos	unemployed		
Arbeitslosigkeit (f)	unemployment		
Arbeitspraktikum (n)	work experience		
Arm (m)	arm		
Armbanduhr (f)	wristwatch		
Arzt/Ärztin (m/f)	doctor		
Arzt/Ärztin (m/f)	doctor		
Asthma (n)	asthma		
atmen	to breathe		
auch	also, too	deck#2	due@2021-10-09 22:40:10
auf dem Lande	in the country	deck#2	due@2021-10-03 02:21:53
auf etwas vorbereiten (sich)	to get ready for		
Aufenthalt (m)	stay		
aufmachen	to open	deck#2	due@2021-10-03 03:39:56
aufmachen	to open		
aufräumen	to tidy up		
aufschlagen	to pitch (tent), to open		due@2021-10-08 22:40:56
Aufschnitt (m)	assorted sliced cold meats		
aufstehen	to get up		
aufwachen	to wake up		
aufwachsen	to grow up		
Auge (n)	eye		
Aula (f)	hall		due@2021-10-08 22:35:06
aus	from, of, out of		
Ausbildung (f)	apprenticeship		
Ausfahrt (f)	exit		
Ausflug (m)	outing, excursion		
ausfüllen	to complete, to fill in		
Ausgang (m)	exit, way out		
Ausgang (m)	way out, exit		
ausgeben	to spend (money)		
ausgebucht	booked up, fully booked		due@2021-10-08 22:38:23
ausgehen	to go out	deck#2	due@2021-10-03 02:24:07
ausgehen	to go out		
Auskunft (f)	information		due@2021-10-08 22:34:56
Ausland (n)	foreign countries, abroad		
ausmachen	to switch off, to turn off		
auspacken	to unpack		
ausruhen (sich)	to rest		
ausruhen (sich), relaxen	to rest, relax		
ausschimpfen	to tell off		
ausschneiden	to cut (text)		
außerdem	besides, also		
Aussicht (f)	view		
Aussprache (f)	pronunciation		
aussteigen	to get off, to alight		
Austausch (m)	exchange		
Ausverkauf (m)	clearance sale		due@2021-10-08 22:40:38
Auswahl (f)	selection, choice		
Ausweis (m)	identity card		
Auszubildende(r) (f/m)	trainee		
Auto (n)	car		
Autobahn (f)	motorway		
Baby (n)	baby		
Baby (n)	baby		
Bäcker/in (m/f)	baker		
Bäckerei (f)	baker's shop		
Bad (n)	bath		
baden	to bathe		
baden	to swim (in the sea)		due@2021-10-08 22:41:27
Badewanne (f)	bath tub		
Badezimmer (n)	bathroom		
Bahn (f)	train, railway		due@2021-10-08 22:35:05
Bahnhof (m)	(railway) station		
Bahnsteig (m)	platform		
Balkon (m)	balcony		
Ball (m)	ball		
Banane (f)	banana		
Band (n)	ribbon		
Bank (f)	bank	deck#2	due@2021-10-09 22:39:56
Bart (m)	beard		
Bauch (m)	tummy		
Bauchschmerzen (pl)	tummy ache		
Bauernhof (m)	farm		
Bauernhof (m)	farm	deck#2	due@2021-10-09 22:40:29
Baum (m)	tree		
Baumwolle (f)	cotton		
bayern	Bavaria		
Beamer (m)	data projector		
Beamte/Beamtin (m/f)	civil servant, official		
bearbeiten	to work on		
bedeckt	overcast		
bedienen	to serve		
bedienen	to serve		
befinden (sich)	to be, to be located, to be situated, to be found		
begeistert	delighted		
begeistert	excited		
beginnt	begins		
begrüßen	to welcome		
begrüßen	to welcome, greet		
bei mir	at (my) home		
beim Arzt bestellt	appointment with the doctor		
Bein (n)	leg		
Beispiel (n)	example		
bekannt	known, familiar		due@2021-10-08 22:35:29
bekommen	to receive		
bekommen	to receive, to get		
Benzin (n)	petrol		
Benzin (n)	petrol		
bequem	comfortable		
Berg (m)	mountain		due@2021-10-02 02:21:32
Beruf (m)	occupation, profession		
Berufsberater/in (m/f)	careers adviser		
Berufsberater/in (m/f)	careers adviser		
Berufspraktikum (n)	work experience		
berühmt	famous		
beschließen	to decide	deck#2	due@2021-10-03 02:22:01
beschreiben	to describe		
beschreiben	to describe		
besetzt	occupied, taken, full		
besichtigen	to visit, to look at, to look around		
besichtigen	to visit, to look at, to look round		
besonders	especially		
besprechen	to discuss		
besprechen	to discuss, debate		
besser	better		
besser gehen	to be better		
bestellen	to order		
besuchen	to visit		
besuchen	to visit		
Besucher/in (m/f)	visitor		
Bett (n)	bed		
Bettdecke (f)	blanket, duvet		
Bettlaken (n)	sheet		
bevor	before		
bevorzugen	to prefer		
bewerben (sich)	to apply		
bewerben für (sich)	to apply for		
Bewerbung (f)	application		
bewölkt	cloudy		
bezahlen	to pay		
bezahlen	to pay	deck#2	due@2021-10-09 22:37:32
Bibliothek (f)	library		
Bibliothek (f)	library		
Bibliothek (f)	library	deck#2	due@2021-10-09 22:35:13
Bier (n)	beer		
Bier vom Fass	draft beer		
Bild (n)	picture		
Bilderroman (m)	graphic novel		
Bildschirm (m)	screen		
Bildschirm (m)	screen, monitor		
Bildung (f)	education		
billig	cheap		
billig	cheap	deck#2	due@2021-10-03 03:40:49
Biologie (f)	biology		
Birne (f)	pear		
bis später	see you later		
bitte	please		
bitte	please	deck#2	due@2021-10-09 22:38:06
Blatt (n)	sheet (of paper)		
blau	blue		
blau	blue		
bleiben	to stay		
Bleiben Sie bitte am Apparat	please hold the line, please stay on the line		
bleifrei	lead free, unleaded		
Bleistift (m)	pencil		
Blick (m) (auf)	view (of)		
Blockflöte (f)	recorder		
blond	blonde		
Blume (f)	flower		
Blume (f)	flower		
Blumenkohl (m)	cauliflower		
Bluse (f)	blouse		
Blut (n)	blood		
Blutwurst (f)	black pudding		
Boden (m)	floor		
Bonbon (m)	sweet	deck#2	due@2021-10-03 03:40:15
Boot (n)	boat		
bowlen gehen	to go ten-pin bowling		
Bratkartoffeln (pl)	fried potatoes		
Bratpfanne (f)	frying pan		
Bratwurst (f)	fried sausage		
brauchen	to need		
brauchen	to need		
braun	brown		
braun	brown		
Braut (f)	bride		
Bräutigam (m)	bridegroom		
brennen	to burn		
Brettspiel (n)	board game		
Brieffreund/in (m/f)	penfriend		
Briefkasten (m)	letter box		
Briefmarke (f)	postage stamp		
Briefträger(in) (m/f)	postman/postwoman		
Briefträger/in (m/f)	postman/postwoman		
Brille (f)	glasses, spectacles		
Brille (f)	glasses, spectacles		
bringe	delivers		
Broschüre (f)	brochure		
Brot (n)	bread		
Brötchen (n)	bread roll		due@2021-10-08 22:35:11
Brücke (f)	bridge		
Bruder (m)	brother		
Brunnen (m)	fountain, well		
Brust (f)	chest		
Buch (n)	book		
buchen	to book		
buchen	to book		
Buchhalter/in (m/f)	accountant		
Buchhandlung (f)	bookshop		
bügeln	to iron		
Bundesstraße (f)	'A' road		
bunt	colorful		
Burg (f)	castle		
Bürger	citizen		
Büro (n)	office		due@2021-10-08 22:33:19
Büro (n)	office		
Büro (n)	office		
bürsten	to brush		
Bus (m)	bus		
Busbahnhof (m)	bus station		
Busfahrer/in (m/f)	bus driver		due@2021-10-08 22:38:28
Butter (f)	butter		
Butterbrot (n)	sandwich		
Call-Center (n)	call centre		
Camcorder (m)	camcorder		
Campingplatz (m)	camp site		
Champignon (m)	mushroom		
Champion, Meister	champion	deck#2	due@2021-10-09 22:37:16
Chatroom (m)	chat room		
chatten	to chat (online)		
Chef/in (m/f)	boss, manager		
Chemie (f)	chemistry		
Chips (pl)	crisps		
Cola (f)	coke		
Computer (m)	computer		
Computer (m)	computer		
Cousin/e (m/f)	cousin	deck#2	due@2021-10-09 22:41:12
Cursor (m)	cursor		due@2021-10-02 02:23:43
da	over there		
Dach (n)	roof		
dadurch	that is how		
damit	(by) that		
danke	thanks		due@2021-10-02 03:42:48
danke schön	thanks very much		
danken	to thank		
darüber	above/over that		
das Baby	baby		
das Bett frisch beziehen	to change the bed		
das Bett machen	to make the bed		
das Bier	beer		
das Brot	bread		
das Buch	book		
das Dach	roof		
das Datum	date		due@2021-10-08 22:34:03
das Dutzend	dozen		
das Ei	egg		
das Eis	ice (cream)		
das Fahrzeug	vehicle		
das Fenster	window		
das Feuerzeug	the lighter		
das Fleisch	meat		
das Geschlecht	gender		
das Geschwister	sibling		due@2021-10-02 03:39:41
das Getränk	the drink		
das Hemd	shirt		
das Insekt	insect		
das Kind	child		
das Kleid	dress		
das Klima	climate		
das Mädchen	girl		
das Müsli	cereal		
das Pferd	horse		
das Publikum	audience		
das Rezept	recipe		
das Salz	salt		
das Schwein	pig		due@2021-10-02 02:25:54
das Sonderangebot	special offer		
das Tier	animal		
das Trinkgeld	tip		
das Zeug	stuff		
dass	that		
dauern	to last		due@2021-10-08 22:35:30
davon	of that		
dazu	for that		
Debatte (f)	debate		
Debitkarte (f)	debit card		
Decke (f)	blanket		
Decke (f)	ceiling, blanket		
decken	to set /lay (the table), to cover		
deine, eure	your		
Demonstrant/in (m/f)	demonstrator		
Demonstration (f)	demonstration		
den	to, that		
denkt	thinking		due@2021-10-02 03:40:20
denn	because, then		
der Apfel	apple		
Der Aufzug	lift		
der Bach	creek		
der Balkon	balcony	deck#2	due@2021-10-09 22:33:07
der Bär	bear		
der Bernstein	amber		
Der Deutsche Filmpreis	German 'Oscar'		
der Durst	thirst		
der Finger	finger		
der Fuß	foot		
der Gutschein	voucher		
der Hund	dog		
der Hunger	hunger		
der Junge	boy		
der Kalender	calendar		
der Käse	cheese		
der Keller	basement		
der Knopf	button		
der Kopf	head		
der Mann	man		
der Mantel	coat		
der Markt	market		
der Mietwagen	rental car		
der Nutzer	user		
der Orangensaft	orange juice	deck#2	due@2021-10-09 22:38:10
der Pass	passport		
der Rock	skirt		
der Salat	salad		
der Senf	mustard		
der Sohn	son		
der Strand	beach		
der Tee	tea		
der Wind	wind		
detaillierte	detailed		
Deutsch (n)	German		
Deutsche Post (f)	German postal service		
dich, du, euch, dir	you		
die aktuellen Nachrichten (pl)	current affairs, news		
die Ampel	traffic light		
die Bäckerei	bakery		
die Bauer/ der Bäuerin	farmer		
die Beziehung	relationship		
die Ente	duck		
die Erdbeere	strawberry		
die Familie	family	deck#2	due@2021-10-09 22:40:49
die Ferien	holiday		
die Fliege	fly		
die Frage	question		
die Frau	woman		
die Gemeinde	community		
die Gruppe	group		
die Hose	pants		
die Jacke	jacket		due@2021-10-02 03:39:34
die Kartoffel	potato		
die Katze	cat		
die Kuh	cow		
die Marmelade	jam		due@2021-10-02 03:40:09
die Mathematik	math		
die Milch	milk		due@2021-10-02 02:21:02
die Olympischen Spiele (pl)	Olympic Games		
die Orange	orange		
die Pizza	pizza		
die Schokolade	chocolate	deck#2	due@2021-10-09 22:33:08
die Schwester	sister		
die Sehenswürdigkeit	attraction, sight to see		
die Speisekarte	menu		
die Tasche	bag		
die Tochter	daughter		
die Verbindung	connection, joining		due@2021-10-08 22:40:06
die Wasser	water		
die Welle	wave		
die Wiese	meadow		
die Zähne putzen (sich)	to clean one's teeth		
die Zeitung	newspaper	deck#2	due@2021-10-09 22:34:34
Dieb/in (m/f)	thief		
diese	this		
Diplom (n)	diploma		
direkt	direct		
Direktor/in (m/f)	headmaster/headmistress, principal, head teacher		
Disko (f)	disco		
Do-it-yourself (n)	DIY		
doch	yet, but		
Dokumentation (Doku) (f)	documentary		
Dom (m)	cathedral		
Donner (m)	thunder		
donnern	to thunder		
Doppelbett (n)	double bed		
Dorf (n)	village		
Dose (f)	tin, can		
Dosenöffner (m)	can opener		
Dosenöffner (m)	tin opener		due@2021-10-08 22:37:41
downloaden, herunterladen	to download		
dran	turn		
drei	three		
dreizehn	thirteen		
dritte	third		
Droge (f)	drug		
Drogenkonsum (m)	drug-taking		
Drogerie (f)	chemist's (non-dispensing)		
drucken	to print		
dumm	stupid		
dumm	stupid		
dünn	thin		
durchfahren	to travel straight through		
Durchfall (m)	diarrhoea		
Dürre (f)	drought		
Durst haben	to be thirsty		
Dusche (f)	shower		
duschen	to shower		
duschen (sich)	to shower		
duzen	to call someone 'du', to address with the familiar 'du'		
DVD-Spieler (m)	DVD player		
E-mail (f or n)	email		
Ecke (f)	corner		
egal	does not matter		
ehrlich	honest, decent, fair		
ehrlich	honest, really		
Ei (n)	egg	deck#2	due@2021-10-09 22:40:31
ein glückliches neues Jahr	Happy New Year		
ein Paar (n)	a couple, a pair		
Einbahnstraße (f)	one-way street		
eindeutig	clear		
eindrucksvoll	impressive		
einfach	easy, simple		
einfach	easy, simple		
einfach	single		
Einfamilienhaus (n)	detached house		
einfügen	to paste (text)		
Eingang (m)	entrance		
eingießen	to pour (in)	deck#2	due@2021-10-03 03:40:42
Einkäufe (pl)	purchases		
Einkäufe machen	to do one's shopping		
Einkäufe machen	to do one's shopping		
einkaufen	to buy		
einkaufen gehen	to go shopping		
einkaufen gehen	to go shopping		
Einkaufszentrum (n)	shopping centre, mall		
einmal	once (a)		
einpacken	to wrap, pack		
eins	one		
einschließlich	including, inclusive		
einsteigen	to get on		
Eintopf (m)	stew		
Eintritt (m)	admission, entry, entrance fee		
Eintrittspreis (m)	admission/entrance fee		
Einwohner	inhabitant		
Einwohner (m)	inhabitant		due@2021-10-08 22:34:42
Einzelfahrkarte (f)	single ticket		
Einzelkind (n)	only child		
einzig	only		
Eis (n)	ice		due@2021-10-02 03:41:23
Eis (n)	ice, ice cream		
Eisbahn (f)	skating rink		
Eisenbahn (f)	train, railway		
Elektriker/in (m/f)	electrician		
elf	eleven		
Eltern (pl)	parents		
Empfang (m)	reception		
Ende (n)	end		
enden	to end, finish		
enden	to end, finish		
endet	ends		
Energie (f)	energy		
Englisch (n)	English		
enkelin	granddaughter		
entdecken	to discover		
Entdeckung (f)	discovery		
Ente (f)	duck		
Ente (f), Entenfleisch (n)	duck		
entlang	along		
entschuldigung	sorry		
entweder	either		
Epidemie, Seuche (f)	epidemic		
er	he		
erbrechen	to vomit		
Erbsen (pl)	peas		
Erdbeben (n)	earthquake		
Erdbeere (f)	strawberry		
Erde (f)	earth, world		
Erdgeschoss (n)	ground floor		
Erdkunde (f)	geography		
Erdöl (n)	crude oil, petroleum		
erfahren	experienced		
erfahren	to experience, to learn of		
erholen (sich)	to recover		
erkältet sein	to have a cold		
erklären	to explain		
erlauben	to allow		
ernst	serious		
Erste Hilfe leisten	to give first aid		
erwachsen	adult	deck#2	due@2021-10-09 22:40:46
Erwachsene (m/f)	adult		
Erwachsene (m/f)	grown-up	deck#2	due@2021-10-09 22:35:20
Erwärmung (f)	warming		
erzählen	to tell (a story)		
Erziehung (f)	education		
es	it		
es gibt	there is		
es tut mir leid	I am sorry		
es tut mir leid	I'm sorry		
Espresso (m)	espresso		
essen	to eat		
essen	to eat		
essen	to eat		
Essen (n)	food		
Essig (m)	vinegar		
Esszimmer (n)	dining room		
Etage (f)	floor, storey		
etwas	some, something		due@2021-10-02 02:25:21
Eurotunnel (m)	Channel Tunnel		
Fabrik (f)	factory		
Fach (n)	subject		
Fähre (f)	ferry		
fahren	to go, to travel, to drive		
Fahrer/in (m)/(f)	driver		
Fahrkarte (f)	ticket		
Fahrrad (n)	bicycle		
Fahrstuhl (m)	lift		
Fahrt (f)	journey		due@2021-10-08 22:33:24
fallen	to fall		
falsch	false		
falsch	incorrect, false		
Familie (f)	family		
Familienname (m)	surname		
Fan (m)	fan	deck#2	due@2021-10-09 22:40:34
Fast-Food-Restaurant (n)	fast food restaurant		
faul	lazy		
faulenzen	to laze about		
Fehler (m)	fault		
Fehler (m)	mistake		
Fehler (m)	mistake		
Feierabend machen	to finish work for the day		
feiern	to celebrate		
Feiertag (m)	public holiday		
Fenster (n)	window	deck#2	due@2021-10-09 22:33:26
Ferien (pl)	holidays		
Ferienjob (m)	holiday job		
fernsehen	to watch television		
Fernseher (m)	television (set)		
Fernsehsendung (f)	television programme		
fertig	ready, finished		
Fest (n)	celebration, festivity	deck#2	due@2021-10-03 02:25:51
Feuerwehrmann/Feuerwehrfrau (m/f)	firefighter		
Feuerwerk (n)	fireworks	deck#2	due@2021-10-09 22:41:24
Fieber (n)	temperature, fever		
finden	to find		
Finger (m)	finger	deck#2	due@2021-10-09 22:40:03
Firma (f)	firm, company	deck#2	due@2021-10-03 03:40:11
Fisch (m)	fish		
Fischhändler/in (m/f)	fishmonger		due@2021-10-08 22:40:41
fit	fit		
Flasche (f)	bottle		due@2021-10-08 22:34:59
Flaschenöffner (m)	bottle opener		
Flaschenöffner (m)	bottle opener		
Fleisch (n)	meat		
fliegen	to fly		
Flöte (f)	flute		
Flughafen (m)	airport		due@2021-10-08 22:34:48
Flugzeug (n)	plane		
Flur (m)	hall, hallway		
Fluss (m)	river		
folgen	to follow	deck#2	due@2021-10-03 02:23:51
Formular (n)	form		
Formular (n)	form		
Forscher/in (m/f)	researcher		
Fortschritt (m)	progress, improvement		
Fotoapparat (m)	camera		
fragen	to ask		
Französisch (n)	French		
Frau (f)	woman, wife		
frei	free		
frei	free, vacant, unoccupied		
Freibad (n)	open-air swimming pool		
Freizeit (f)	free time, spare time		
Freizeitpark (m)	theme park		
fressen	to eat, to scoff		
Freund/in (m/f)	friend		
Freundin	girlfriend		
freundlich	friendly, kind, nice		
Freundschaft (f)	friendship		
frisch	fresh		due@2021-10-02 03:40:06
frisch	fresh, cool		
Friseur/Friseuse (m/f)	hairdresser		
Friseur/Friseuse (m/f)	hairdresser		
frohe/fröhliche Weihnachten	Merry Christmas		
früh	early		
Frühstück (n)	breakfast		
frühstücken	to have breakfast		
Frühstückscerealien (pl)	breakfast cereals		due@2021-10-08 22:35:16
Führerschein (m)	driving licence		
füllen	to fill		due@2021-10-08 22:41:10
Fundbüro (n)	lost property office		
Fundbüro (n)	lost property office		
fünfzehn	fifteen		
fünfzehn Tage	a fortnight		
fünfzig	fifty		
Fuß (m)	foot		
Fuß (m)	foot		
Fußball (m)	football		
Fußboden (m)	floor		
Fußgänger (m)	pedestrian		
Fußgänger (m)	pedestrian		
Fußgängerzone (f)	pedestrian precinct		
Gabel (f)	fork		
Galerie (f)	gallery		
Gameshow (f)	game show		
Gardine (f)	net curtain		
Garten (m)	garden		
Gartenarbeit (f)	gardening		
Gas (n)	gas		
Gasthaus (n)	inn		
Gebäck (n)	biscuits, pastries		
Gebäude (n)	building		
Gebäude (n)	building		
geben	to give		
geboren	born		
geboren	born		
geboren sein	to be born		
gebrauchen	to use, to need		
gebrochen	broken		
Gebühr (f)	charge, fee		
Geburt (f)	birth		
Geburtstag (m)	birthday		
Geburtstag (m)	birthday		
gefallen	to like, to please		
Gefrierschrank (m)	freezer		
gegen	against		
gegen	against, towards	deck#2	due@2021-10-03 02:22:12
Gegend (f)	area		
gegenüber	opposite		
Gegner	opponent		
Gehalt (n)	salary		
gehen	to go		
gehen	to go, to walk		
gehören	to belong to		
Geige (f)	violin		
Geld (n)	money		
Gemüse (n)	vegetables		
Gepäck (n)	luggage		
Gepäckaufbewahrung (f)	left-luggage office		
Gepäckschließfach (n)	left-luggage locker		
geradeaus	straight on		
geräuchert	smoked		
gern (haben)	to like		
gern geschehen	you're welcome	deck#2	due@2021-10-03 02:23:48
gerne	like		
Geschäft (n)	shop, business	deck#2	due@2021-10-03 02:21:37
Geschäftsmann/frau (m/f)	businessman/woman		
Geschenk (n)	present		
Geschenk (n)	present, gift		
Geschenke austauschen	to exchange gifts		
Geschichte (f)	history		
geschieden	divorced		
Geschirrspüler (m)	dishwasher		
Geschirrspülmaschine (f)	dishwasher		
Geschmack (m)	flavour		due@2021-10-08 22:37:53
geschwätzig	chatty, talkative		
Geschwindigkeit (f)	speed		
Gesellschaft (f)	company		
Gesicht (n)	face		
Gesicht (n)	face		
gestorben	dead		
gestreift	striped		
gesund	healthy		
gesund	healthy		
Gesundheit (f)	health		
Getränk (n)	drink		
Gewichtstraining (n)	weight training		
Glas (n)	glass		
Glas (n)	glass		
Glas (n)	glass		
Glatze (f)	bald head		due@2021-10-08 22:40:17
gleiche	same		
Gleis (n)	track, platform		
global	global		
glücklich	happy, pleased, glad		
Glückwunschkarte (f)	greetings card		
Goldfisch (m)	goldfish		
Gott/Göttin (m/f)	G(g)od, goddess	deck#2	due@2021-10-03 02:25:36
Grad (m)	degree		
Grad (m)	degree		
Gras (n)	grass		
gratis, kostenlose	free of charge		
grau	grey		
Grenze (f)	border		
Grenze (f)	border	deck#2	due@2021-10-03 02:25:49
Grippe (f)	flu		
groß	big		
groß	tall, big		
Größe (f)	size		
Großmutter (f)	grandmother		
Großvater (m)	grandfather		
großzügig	generous		
grün	green	deck#2	due@2021-10-09 22:38:12
Grundschule (f)	primary school		due@2021-10-08 22:35:36
Grundschullehrer/in (m/f)	primary school teacher		
Gruselfilm (m)	horror film		
Gurke (f)	cucumber		
Gürtel (m)	belt		
gut	good		
gut	good		
gut bezahlt	well paid		
gute nacht	good night		
gute Reise	safe journey		
guten Appetit	enjoy your meal		
Guten Appetit!	Enjoy your meal!		
Gymnasium (n)	grammar school		
Haar/e (n/pl)	hair		
Haarbürste (f)	hairbrush		
Hafen (m)	port, harbour		
Hahn (m)	tap		
Hähnchen (n)	chicken		
Halbbruder (m)	half-brother		
Halbpension (f)	half-board		
Halbschwester (f)	half-sister		
Hallenbad (n)	indoor swimming pool		
Hals (m)	throat		
Halsschmerzen (pl)	sore throat		
halten	to stop		
Haltestelle (f)	stop		due@2021-10-08 22:40:43
Hammelfleisch (n)	mutton		
Hand (f)	hand		
Handschuh (m)	glove		
Handtasche (f)	handbag		
Handy (n)	mobile phone		
hart	hard		
harte Drogen	hard drugs		
hassen	to hate		
hässlich	ugly		
Hauptgericht (n)	main course		
Hauptschule (f)	secondary school		due@2021-10-08 22:33:17
Haus (n)	house		due@2021-10-02 03:41:13
Hausaufgabe (f)	homework		
Hausfrau (f)	housewife		
Haustier (n)	pet		
headphones	Kopfhörer (m)		
Heft (n)	exercise book		
Heimfahrt (f)	journey home		
heiraten	to marry		
heiß	hot		
heißen	to mean/call		
helfen	to help		
helfen	to help		
Hemd (n)	shirt		
Herd (m)	cooker		
herum	around		
herumzappen	to channel hop		
Herz (n)	heart		
herzlich	warm, sincere		
herzlichen Glückwunsch (m)	congratulations, good wishes		
hier	here		
Hilfe (f)	help		
Himbeere (f)	raspberry		
Himmel (m)	sky		due@2021-10-02 02:24:00
hin und zurück	return, there and back		
historisch	historic(al)		
Hitze (f)	heat		
hitzefrei	(rest of) day off because of excessively hot weather		
Hobby (n)	hobby, pastime		
Hobby (n)	hobby, pastime		
hoch, hohe	high		
hochladen	to upload		
Hochzeit (f)	wedding		
Hof (m)	playground		
hoffen	to hope		
höflich	polite		
holen	to fetch		
Holz (m)	wood, timber		
hören	to hear, to listen to		
hören	to hear, to listen to		
Hose (f)	pair of trousers		
Hose (f)	trousers	deck#2	due@2021-10-09 22:41:08
hübsch	pretty		
Hügel (m)	hill		
Hühnchen (n)	chicken, hen		
Hund (m)	dog		
Hunger haben	to be hungry		
husten	to cough		
Hut (m)	hat		
ich	I	deck#2	due@2021-10-09 22:40:33
im Ausland	abroad		
im Ausland	abroad		
im Bett bleiben	to stay in bed		
im ersten Stock	on the first floor		
im voraus	in advance		
im, in	in (the)		
Imbiss (m)	snack		
Imbissstube (f)	snack bar		
immer	always		
in der Nähe von	close to		
in der Nähe von	near		
In ordnung!	OK!		
in, drinnen	inside		
industriell	industrial		
Informatik (f)	computer science		
Informatiker/in (m/f)	computer specialist, IT expert		
Informationen (pl)	information		
Informationsbüro (n)	information		
Ingenieur/in (m/f)	engineer		
inidividuell	distinct		
inklusive	inclusive	deck#2	due@2021-10-09 22:34:06
Inlineskaten (n)	roller blading		
ins Bett gehen	to go to bed		
interaktives Whiteboard (n)	interactive whiteboard		
interessant	interesting		due@2021-10-02 03:39:59
interessant	interesting		
international	international		
Interview (n)	interview		
irgendwann	sometime		
irgendwas	something		
irgendwer	someone		
irgendwie	somehow		
irgendwo	somewhere		
ist	is		
Italienisch	Italian		
ja	yes		
Jacke (f)	jacket		
Jahreszeit (f)	season		
jährlich	yearly		
Jeans (pl)	jeans		
jedenfalls	nonetheless		
jeder	every		
jobben	to do casual jobs		
joggen	to jog		
Joghurt (m)	yoghurt		
Journalist/in (m/f)	journalist		due@2021-10-02 03:42:52
Jugendherberge (f)	youth hostel		
Jugendklub (m)	youth club	deck#2	due@2021-10-03 02:22:22
Jugendliche (m/f)	young person		
jung	young		
Junge (m)	boy		
jünger	younger		
Jura (pl)	law (as a subject)		
Kaffee (m)	coffee		
Kaffee und Kuchen	coffee and cake (afternoon snack)		
Kaffeemaschine (f)	coffee maker		
Kalbfleisch (n)	veal		
kalt	cold		
kalt	cold		
Kälte (f)	cold		
Kamera (f)	camera		
Kaninchen (n)	rabbit		due@2021-10-08 22:34:51
Kaninchen (n)	rabbit		
kaputt	broken		
Karneval (m)	carnival		
Karotte (f)	carrot		
Karriere (f)	career		
Karte (f)	ticket		
Karte (f)	ticket		
Kartoffel (f)	potato		
Käse (m)	cheese		
Käsebrot (n)	cheese sandwich		
Kasse (f)	till, cash desk, checkout		
Kasse (f)	till, cash desk, checkout		due@2021-10-08 22:33:48
Kassierer/in (m/f)	cashier		
Katastrophe (f)	catastrophe		
Kathedrale (f)	cathedral		due@2021-10-02 02:21:57
Katze (f)	cat		
Katze (f)	cat		
kaufen	to buy		
Kauffrau (f)	businesswoman		
Kaufhaus (n)	department store		
Kaufmann (m)	businessman	deck#2	due@2021-10-03 02:22:25
Kegelbahn (f)	bowling alley		
kehren	to turn, to sweep		
Keller (m)	cellar		
Kellner/in (m/f)	waiter/waitress		
kennen	to know (a person)		
kennen lernen	to get to know, to meet		
kennen lernen	to meet (become acquainted with)		
kennen lernen	to meet, make the acquaintance of		
Kerze (f)	candle		
Kilometer (m)	kilometre		
Kind (n)	child		
Kind (n)	child		
Kindergarten (m)	nursery		
Kindergarten (m)	nursery school		
Kindheit (f)	childhood		
Kirche (f)	church		
Kirsche (f)	cherry		
klar	clear (visibly)		
Klassenarbeit (f)	class test		
Klassenzimmer (n)	classroom		
Klavier (n)	piano		
Kleid (n)	dress		
Kleid (n)	dress	deck#2	due@2021-10-09 22:40:58
Kleidung (f)	clothing, clothes		
Kleidungsstück (n)	garment, article of clothing		
klein	small		
klein	small, short (person)		
kleines	smaller		
Kleingeld (n)	(small or loose) change		
Klempner(in) (m/f)	plumber		
Klempner/in (m/f)	plumber		
klettern	to climb		
klicken	to click		
Klima (n)	climate		
Klimatisierung (f) (OR Aircondition)			
klingeln	to ring		
Klinik (f)	clinic		
Klo (n)	loo		
klug	clever		
knapp	scarce		
Knie (n)	knee		
Koch/Köchin (m/f)	cook, chef		
kochen	to cook		
Kochtopf (m)	saucepan		due@2021-10-08 22:34:09
Koffer (m)	suitcase		
Kofferraum (m)	boot (of car)		
Kohl (m)	cabbage	deck#2	due@2021-10-03 03:40:28
Kohle (f)	coal		
kohlensäurehaltiges Getränk (n)	fizzy drink		
komisch	funny		
Komödie (f)	comedy		
komplett	complete		
Konditorei (f)	cake shop		
König (m)	king		
Königin (f)	queen		
Kontrolleur (m)	inspector		
kontrollieren	to check		
Kopf (m)	head	deck#2	due@2021-10-09 22:37:43
Kopfkissen (n)	pillow		
Kopfschmerzen (pl)	headache		
kopieren	to copy	deck#2	due@2021-10-03 02:21:45
Körper (m)	body		
korrigieren	to correct	deck#2	due@2021-10-03 02:24:14
kosten	to cost		
kosten	to cost		
kosten	to cost		
Kotelett (n)	chop, cutlet		
Krabbe (f)	shrimp, prawn		
krank	ill, sick		
krank fühlen (sich)	to feel ill, sick		
Krankenhaus (n)	hospital		
Krankenpfleger (m)	(male) nurse		
Krankenschwester (f)	(female) nurse		
Krankenwagen (m)	ambulance	deck#2	due@2021-10-03 02:24:22
Krankheit (f)	illness		
Krawatte (f)	tie		
Kreditkarte (f)	credit card		
Kreisverkehr (m)	roundabout		
Kreuzung (f)	crossroads		due@2021-10-08 22:35:32
Kreuzung (f)	crossroads		
Krise (f)	crisis		
Küche (f)	kitchen		
Kuchen (m)	cake		due@2021-10-02 03:40:47
Kuchen (m)	cake		
Kugelschreiber (m)	ballpoint pen		
Kuh (f)	cow		
kühl	cool		
kühl	cool		
Kühlschrank (m)	fridge		
Kuli (m)	ballpoint pen		
Kunde/Kundin (m/f)	customer		
Kunde/Kundin (m/f)	customer, client		
Kunst (f)	art		
küssen	to kiss		
Küste	coast, seaside		
Labor (n)	laboratory		
lachen	to laugh		
Lachs (m)	salmon		due@2021-10-08 22:33:29
Laden (m)	shop		
Laden (m)	small shop		
Lagerfeuer (n)	bonfire		
Lammfleisch (n)	lamb		
Land (n)	country, countryside, land		due@2021-10-02 02:25:44
Land (n)	country, countryside, land		
landen	to land		
Landschaft (f)	landscape, scenery, countryside		
Landstraße (f)	main arterial road		due@2021-10-08 22:41:06
lang	long		
lang	long		
langsam	slow(ly)		
language assistant	Fremdsprachenassistent/in (m/f)		
langweilig	boring		
langweilig	boring		
langweilig	boring		
Laptop (m, n)	laptop		due@2021-10-02 03:41:25
laufen	to run		
laufen	to run		
laufen	to walk		
laut	loud		
leben	to live		
Lebensmittel (pl)	food, groceries		
Leberwurst (f)	liver sausage		
lecker	delicious, tasty		
lecker	tasty	deck#2	due@2021-10-09 22:33:21
Leder (n)	leather		
ledig	single, unmarried		
leer	empty		
leeren	to empty		
Lehre (f)	apprenticeship		
Lehrer/in (m/f)	teacher		
Lehrer/in (m/f)	teacher		
Lehrerzimmer (n)	staff room		
Lehrling (m)	apprentice		
leicht	easy		due@2021-10-02 02:25:26
Leichtathletik (f)	athletics		
leichter	lighter		
leiden	to suffer		due@2021-10-08 22:34:54
leider	unfortunately		
leise	quiet		
leise	quiet		
lernen	to learn		
lesen	to read		
lesen	to read		
Lesen (n)	reading		
letzten	last		
Licht (n)	light		
Licht (n)	light		
Licht (n)	light		
lieben	to love	deck#2	due@2021-10-03 03:40:54
lieben	to love		due@2021-10-08 22:37:23
lieben	to love		
lieber	prefer, sweet		
lieber (haben)	to prefer		
Lieblingsfach (n)	favourite subject		
Lied (n)	song		
Lift (m)	lift		
Limonade (f)	lemonade		
Lineal (n)	ruler		
links	(on the) left		
Lippenstift (m)	lipstick		
LKW (m)	lorry, truck		
lockig	curly		
Löffel (m)	spoon		
Lohn (m)	wage(s), pay	deck#2	due@2021-10-03 02:25:18
Luftkissenboot (n)	hovercraft		
Luftsteward/ess (m/f)	air steward/air stewardess		
lustig	funny, amusing		
machen	to make		due@2021-10-02 02:24:09
Mädchen (n)	girl		
Magen (m)	stomach		
Magenschmerzen (pl)	stomach ache	deck#2	due@2021-10-03 03:42:56
Mahlzeit (f)	meal		
malen	to paint		due@2021-10-08 22:38:02
malerisch	picturesque		
manche	some		
manchmal	sometimes		
Mann (m)	man, husband		
Mannschaft (f)	team		
Mantel (m)	coat		
Mappe (f)	briefcase, folder, file		
Markt (m)	market		
Marktplatz (m)	market square		
Marmelade (f)	jam		
Maschine (f)	plane		due@2021-10-08 22:34:44
Mathe (f)	maths		
Mauer (f)	wall (outside, external)		
Maurer/in (m/f)	bricklayer, mason, builder		
Maus (f)	mouse		
Maus (f)	mouse		
Mechaniker/in (m/f)	mechanic		
Medaille (f)	medal		
Medikament (n)	medicine		
Meeresfrüchte (pl)	seafood		
Meerschweinchen (n)	guinea pig		
Mehl (n)	flour		
mein	my, mine		
Menschenrechte (pl)	human rights		
Messer (n)	knife	deck#2	due@2021-10-09 22:35:09
Messer (n)	knife		
Meter (m)	metre		
Metzgerei (f)	butcher's	deck#2	due@2021-10-03 02:21:39
Metzgerei (f)	butcher's shop		
mich, mir	me		
Miete (f)	rent		
mieten	to rent, to hire		due@2021-10-08 22:35:18
Mikrowelle (f)	microwave		
Mikrowellenherd (m)	microwave oven		
Milch (f)	milk		
Mineralwasser (n)	mineral water		
mir geht's gut	I'm doing well		
mir ist kalt	I am cold		
mir ist warm	I am warm/hot		
mit Untertiteln	subtitled		
Mittagessen (n)	lunch		
Mittagessen (n)	lunch, mid-day meal		
Mittagspause (f)	lunch break		
Mittlere Reife (f)	equivalent to GCSEs		
Möbel (pl)	furniture		
Möbelstück (n)	piece of furniture		
Mobiltelefon (n)	mobile phone		
Mode (f)	fashion		
Model (n)	model		
Moderator/in (m/f)	presenter		
Moderator/in (m/f)	presenter		
modern	modern		
Mofa (n)	moped		
mögen	to like		
mögen	to like		
möglich	possible	deck#2	due@2021-10-03 02:23:54
monatlich	monthly		
montags, dienstags etc	on Mondays, on Tuesdays etc		
morgens	in the mornings		
Moschee (f)	mosque		
Motor (n)	engine		
Motorrad (n)	motorbike		
Mücke (f)	midge, mosquito, gnat		
müde	tired		
Müdigkeit	tiredness		
Müll (m)	rubbish, refuse		
Mülleimer (m)	dustbin		
Mund (m)	mouth		
Mund (m)	mouth		
mündlich	oral		
Münze (f)	coin		
Muscheln (pl)	mussels		
Museum (n)	museum		
Museum (n)	museum		
Musik (f)	music		
Musik (f)	music		
Musiksaal (m)	music room		
musizieren	to play a musical instrument		
Mutter (f)	mother		
Muttertag/Vatertag (m)	Mother's Day, Father's Day		
Mutti (f)	mum		
nach Hause gehen	to go home		
nach oben gehen	to go upstairs		
nach unten gehen	to go downstairs		
Nachbar/in (m/f)	neighbour		
nachmittags	in the afternoons		
Nachname (m)	family name		
Nachname (m)	surname		
Nachrichten (pl)	news		
Nachrichtensendung (f)	news broadcast		
Nachrichtensprecher/in (m/f)	newsreader		
nachsitzen	to have a detention		
Nachspeise (f)	dessert	deck#2	due@2021-10-03 02:25:50
nächst	next		
Nachtklub (m)	nightclub		
Name (m)	name		
Nase (f)	nose		
Naturwissenschaften (pl)	sciences, science subjects		
Nebel (m)	fog		
nebelig	foggy		
Neffe (m)	nephew		
nehmen	to take		
nein	no		
nett	nice		
neu	new		
Neujahr (n)	New Year, New Year's Day		
Neujahrstag (m)	new year's day		
neunzig	ninety		
nicht	not		
Nichte (f)	niece		
Nobelpreis (m)	Nobel Prize		
noch	still, yet, more		
Nord (m)	north		
normal	normal		
Notanruf (m)	emergency call		
Note (f)	mark, grade		
notwendig	necessary		
Nudeln (pl)	pasta, noodles		
nützlich	useful		
nützlich	useful		
ob	if, whether		
Oberstufe (f)	last/final year of school/Sixth For		
obwohl	though		
oder	or		
offen	open		
öffentlich	public		
office	Buro		
öffnen	to open		
öffnen	to open		
oft	often		
ohne	without		
Ohr (n)	ear		
Ohrenschmerzen (pl)	earache		
Ohrringe (pl)	earrings		
ökologisch	ecological		due@2021-10-08 22:34:45
Öl (n)	oil		
Öl (n)	oil		
Ölteppich (m)	oil slick		
Oma (f)	grandma		
Omelett (n)	omelette		
Onkel (m)	uncle		
online	online		
Opa (m)	granddad		
Opfer (n)	victim	deck#2	due@2021-10-03 02:23:16
Orange (f)	orange		
organisch	organic		
original	original		
Ort (m)	place		
Ost (m)	east		
Ostern (n)	Easter		
Overhead-Projektor (m)	overhead projector		
Palast (m)	palace		
Panne (f)	breakdown, puncture		
Papier (n)	paper		
Parfum, Parfüm (n)	perfume		
Park (m)	park		
parken	to park		
Parkplatz (m)	car park		
Party, Fete (f)	party		
Pass (m)	passport		
passt	fits		due@2021-10-02 03:41:16
Passwort (n)	password		
Pastete (f)	paté		
Pause (f)	break, playtime, recreation	deck#2	due@2021-10-03 03:40:05
Pension (f)	guest house		
per Anhalter fahren	to hitchhike		
perfekt	perfect		
Person (f)	person		
Pfannkuchen (m)	pancake	deck#2	due@2021-10-03 02:24:13
Pfeffer (m)	pepper		
Pferd (n)	horse		
Pfirsich (m)	peach		
Pflanze (f)	plant		
Pflaster (n)	plaster		
Pflaume (f)	plum		
Pflichtfach (n)	compulsory subject		
Physik (f)	physics		due@2021-10-02 03:40:57
Picknick (n)	picnic		
Pille (f)	pill		
Pilot/in (m/f)	pilot		
pink	pink		
Plakat (n)	poster		due@2021-10-08 22:34:29
Plan (m)	plan		
Plastik(tüte) (f)	(plastic) bag		
Platz (m)	seat		
Platz (m)	square, space		
plaudern	to chat	deck#2	due@2021-10-03 02:21:42
plaudern	to chat		
plötzlich	suddenly		
Politik (f)	politics, policy		
Polizei (f)	police		
Polizeiwache (f)	police station		
Polizeiwache (f)	police station		
Polizist(in) (m/f)	police officer		
Polizist/in (m/f)	policeman/policewoman		
Pommes (Frites) (pl)	chips, fries		
Portemonnaie (n)	purse, wallet		
positiv	positive		
Postamt (n)	post office	deck#2	due@2021-10-03 02:22:00
Poster (n)	poster		
Postkarte (f)	postcard		
praktisch	practical		
Preis (m)	price		
Preis (m)	price		
Preis (m)	price		
Preis (m)	prize		
Preisliste (f)	list of prices		
preiswert	good value, inexpensive, cheap		
Premierminister/in (m/f)	prime minister		
Programm (n)	programme, channel		
Prominente(r) (f/m)	celebrity		
Prüfung (f)	exam		
Psychologie (f)	psychology		due@2021-10-02 03:42:50
Pulli (m)	sweater, pullover		
Pullover (m)	sweater, pullover		
pünktlich	on time		
Puppe (f)	doll		
Pute (f)	turkey		
putzen	to clean (teeth etc)		
Qualifikation (f)	qualification		
qualifiziert	qualified		
qualifiziert	qualified		
qualifiziert	qualified		
Rad (n)	wheel, bike		
Rad fahren	to ride a bike, go cycling		
Radiergummi (n)	rubber		
Radio (n)	radio		
Rakete (f)	rocket		
Rasen (m)	lawn		
rasieren (sich)	to shave		
Rathaus (n)	town hall		
rauchen	to smoke		
Raucher/in (m/f)	smoker		
Reality-TV (n)	reality television		
Realschule (f)	equivalent to secondary school	deck#2	due@2021-10-03 02:23:40
Rechner (m)	calculator		
Rechnung (f)	bill		
rechts	(on the) right		
Recycling (n)	recycling		
Regal (n)	shelf, shelving	deck#2	due@2021-10-03 03:40:51
Regel (f)	rule, regulation		
Regen (m)	rain		due@2021-10-08 22:38:30
Regenmantel (m)	raincoat		
Regenschauer (m)	shower		
Regenschirm (m)	umbrella		
Regenwald (m)	rainforest		
Region (f)	region		
regional	regional		
regnen	to rain		
reich	rich		
Reifen (m)	tyre		
rein	pure		
Reis (m)	rice		
Reise (f)	journey		
Reiseleiter/in (m/f)	tourist guide		
reisen	to travel		
Reisende (m/f)	traveller		
Reisescheck (m)	traveller's cheque		
reiten	to ride (a horse)		due@2021-10-08 22:40:48
relaxen	to relax		
Religion (f)	religious education, religion		
rennen	to run		
reparieren	to repair		
reservieren	to reserve		
retten	to save		
Rettich (m)	radish		
Rezept (n)	prescription		
Rezept (n)	recipe		due@2021-10-08 22:37:30
richtig	correct		
richtig	right, correct		
Rindfleisch (n)	beef		
Ring (m)	ring		
Ring (m)	ring (jewellery)		
Rock (m)	skirt		
Roman (m)	novel		
romantisch	romantic		
Rosenkohl (m)	sprouts		due@2021-10-08 22:37:49
rot	red		
Rotkohl (m)	red cabbage		
Rotwein (m)	red wine		
Rückenschmerzen (pl)	backache	deck#2	due@2021-10-03 03:40:01
Rückfahrkarte (f)	return ticket		
Rucksack (m)	backpack		
ruhig	calm		
ruhig	quiet, peaceful		
rührend	moving		
rund	round		due@2021-10-02 03:39:50
Saft (m)	juice		
Sahne (f)	cream		
Sakko (n or m)	jacket		
Salat (m)	lettuce, salad		
Salz (n)	salt		
salzig	salty		
Sand (m)	sand		
Sandburg (f)	sand castle		
Sänger/in (m/f)	singer		
Satellitenfernsehen (n)	satellite TV		
sauber	clean		
sauber	clean		
sauber machen	to clean		
sauer	sour		
Sauerbraten (m)	marinated beef pot roast		
Sauerkraut (n)	pickled cabbage		
Sauerregen (m)	acid rain		
Schach (n)	chess	deck#2	due@2021-10-03 02:25:51
Schaf (n)	sheep		
Schalter (m)	ticket counter, ticket office		
scharf	sharp		
Schaufenster (n)	shop window		
Schaufensterbummel (m)	window shopping		
Schauspiel (n)	play		
Schauspieler/in (m/f)	actor/actress		
Schauspieler/in (m/f)	actor/actress		
Scheck (m)	cheque		
Scheibe (f)	slice	deck#2	due@2021-10-03 02:25:34
schicken	to send		
schicken	to send		
Schiff (n)	ship		
Schildkröte (f)	tortoise		
Schinken (m)	ham		
Schinkenbrot (n)	ham sandwich		
Schlafanzug (m)	pyjamas		
schlafen	to sleep		
schlafen	to sleep		
schlafen	to sleep		
Schlafsack (m)	sleeping bag		
Schlafzimmer (n)	bedroom		
schlagen	to hit, knock		
Schläger (m)	racket		due@2021-10-08 22:40:08
Schlagzeug (n)	drums		
schlank	slim		
schlecht	bad	deck#2	due@2021-10-09 22:38:05
schlecht	bad		
schlecht bezahlt	poorly paid	deck#2	due@2021-10-03 03:42:53
schließen	to close		
schlimm	severe		
Schlips (m)	tie		
Schloss (n)	castle		
Schlüssel (m)	key		
Schlüsselbund (m)	key ring		
Schlussverkauf (m)	end of season sale		
schmecken	to taste		
schmekt	tastes		
Schminke (f)	makeup		
Schmuck	jewellery		
Schmuckgeschäft (n)	jewellery shop		
schmutzig	dirty		
Schnee (m)	snow		
schneiden	to cut		
schneiden	to cut		
schneien	to snow		
schnell	fast		
schnell	quick(ly), fast		
Schnitzel (n)	escalope	deck#2	due@2021-10-03 03:41:26
Schokolade (f)	chocolate		due@2021-10-02 02:23:22
schön	beautiful, lovely, handsome		
schön	pretty		
Schrank (m)	cupboard		
Schreibwarengeschäft (n)	stationery shop		
schriftlich	written, in writing		
Schublade (f)	drawer		
schüchtern	shy	deck#2	due@2021-10-03 03:41:17
Schuh (m)	shoe		
Schulanfang (m)	beginning of term		
Schule (f)	school		
Schüler/in (m/f)	pupil		
schulfrei	no school		
Schulhof (m)	playground		
Schultag (m)	school day		
Schüssel (f)	bowl		
schützen	to protect		
schwach	weak		
schwach	weak		
schwarze	black		
Schwein (n)	pig		
Schweinebraten (m)	joint of pork, roast pork		
Schweinefilet (n)	pork fillet		
Schweinefleisch (n)	pork		
schwer	heavy, hard (difficult)		
Schwester (f)	sister		
schwierig	difficult, hard		
Schwimmbad (n)	swimming pool		
schwimmen	to swim		
schwimmen	to swim		
schwimmen gehen	to go swimming		
schwindlig	dizzy		
sechs	six		
sechste	sixth		
sechzehn	sixteen		
sechzig	sixty		
See (f)	sea		
See (m)	lake		
segeln	to sail		
sehen	to see		
sehen	to see		
Sehenswürdigkeit (f)	sight, place of interest		
sehr	very	deck#2	due@2021-10-03 03:41:28
seiden	made of silk		
Seife (f)	soap		
Seifenoper (f)	soap opera		
Sekt (m)	champagne		
selber	myself		
selbst	yourself		
Selbstbedienung (f)	self-service		
selbstsicher	self-confident		
selbstsüchtig	selfish		
selbstverständlich	of course		due@2021-10-08 22:35:27
selten	rare(ly)	deck#2	due@2021-10-03 03:39:45
seltsam	odd, strange, curious		
Semester (n)	semester		
Sender (m)	broadcaster, station		
Sendung (f)	programme, broadcast		
Senf (m)	mustard		
Serie (f)	series		
Serviette (f)	serviette		
Sessel (m)	armchair, easy chair		
setzen (sich)	to sit down		
Shampoo (n)	shampoo		
Shorts (pl)	shorts		
sich sonnen	to sunbathe	deck#2	due@2021-10-03 02:22:28
Sicherheit (f)	safety		
sichtbar	visible	deck#2	due@2021-10-03 03:41:02
siebte	seventh		
siebzig	seventy		
siezen	to call someone 'Sie', to use the polite form of address		
Silvester (m)	New Year's Eve		
Silvester feiern	to celebrate New Year		
sind	are		
singen	to sing		
Sitcom (f)	sitcom		
Sitz (m)	seat		
sitzen	to sit, to be sitting		due@2021-10-08 22:35:34
sitzen bleiben	to stay down a year		
skateboarden, Skateboard fahren	to skateboard		
Ski laufen	to ski		
SMS (f)	text message		
so	like this		
Socke (f)	sock		
Sofa (n)	sofa, settee		
Software (f)	software		
Sohn (m)	son		
solange	as long as		
Soldat/in (m/f)	soldier	deck#2	due@2021-10-09 22:33:35
Sommer (m)	summer		
Sommerferien (pl)	summer holidays		
sondern	but rather		
Sonne (f)	sun		
Sonnenbrand (m)	sunburn		
Sonnenbrille (f)	sunglasses		
Sonnencreme (f)	sun cream		
sonnig	sunny		
sonst	else, otherwise		
sortieren	to sort		
Souvenirladen (m)	souvenir, gift shop		
sowohl	both, and		
soziales Netz (n)	social network		
Sozialkunde (f)	social studies		
Spanisch (n)	Spanish		
spannend	exciting, gripping		
sparen	to save		
Sparkasse (f)	savings bank		
Spaß (machen)	to be fun		
Spaß haben	to have fun		
Spaß haben	to have fun		
spät	late		
spät	late		
spazieren	to walk		
spazieren gehen	to go for a walk		due@2021-10-08 22:33:56
Speck (m)	bacon		
Speise (f)	meal, food		
Speisesaal (m)	dining room		
Spezialeffekte (pl)	special effects		
Spezialität des Hauses (f)	speciality of the house		
Spiegelei (n)	fried egg		
Spiel (n)	game		
Spiel (n)	game, match		
spielen	to play		
Spieler/in (m/f)	player		due@2021-10-08 22:41:20
Spielzeug (n)	toy		
Spielzeug (n)	toy		
Spion/in (m/f)	spy		
Spitzer (m)	sharpener		due@2021-10-08 22:37:33
Sport (m)	sport		
Sport treiben	to do/play sport		
Sportler/in (m/f)	sportsman/sportswoman		
sportlich	sporty		
sportlich	sporty		
Sportzentrum (n)	sports centre		
Sportzentrum (n)	sports centre		
Sprache (f)	language		
sprechen	to speak		
Sprechstunde (f)	surgery		
springen	to jump		
springen	to jump		
Spritze (f)	injection	deck#2	due@2021-10-03 03:40:58
Sprudel (m)	sparkling mineral water		due@2021-10-08 22:41:03
Spülbecken (n)	kitchen sink		
Spülmaschine (f)	dishwasher		
Staatsangehörigkeit	nationality, citizenship		
Staatsangehörigkeit (f)	nationality		
Stadion (n)	stadium		
Stadion (n)	stadium		
Stadt (f)	town		
Stadtmitte (f)	town centre		
Stadtplan (m)	street map		
Stadtteil (m)	part of town, district		
Star (m)	star		
stark	strong		
stark	strong		
starten	to take off		
Stau (m)	traffic jam		
Staub saugen	to vacuum		
Staubsauger (m)	vacuum cleaner		
steigen	to go up (temperature)		
Stelle (f)	job, post, position		
stellen	to ask (a question)		
Stellenanzeige (f)	job advertisement		
sterben	to die		
Stereoanlage (f)	stereo system		
Stern (m)	star		
Steward(ess) (m/f)	flight attendant		
Stich (m)	sting, bite		
Stift (m)	pen		
Stimme (f)	voice		
stimmen	to vote, to be correct		
Stock (m)	floor, storey		
Stock (m)	floor, storey		
Stockwerk (n)	floor, storey		
Strand (m)	beach		
Straße (f)	road, street		
Straßenbahn (f)	tram		
Streichholz (n)	match		
streng	strict		
Stress (m)	stress		
Strumpfhose (f)	tights		
Strumpfhose (f)	tights		
Stück (n)	piece		
Student/in (m/f)	student		
Student/in (m/f)	student		
Student/in (m/f)	student		
studieren	to study		
Studium (n)	study, studies		
Stuhl (m)	chair		
Stunde (f)	lesson		
Stundenplan (m)	timetable		
Stundenplan (m)	timetable		due@2021-10-08 22:41:00
Sturm (m)	storm		
suchen	to look for		
Süd (m)	south		
Supermarkt (m)	supermarket		
Suppe (f)	soup		
surfen	to surf (browse) the internet		
süß	sweet		
süß	sweet		
süß	sweet		
Süßigkeiten (pl)	sweets		
Süßwarengeschäft (n)	sweet shop		
Süßwarengeschäft (n)	sweet shop		
Sweatshirt (n)	sweatshirt		
sympathisch	nice	deck#2	due@2021-10-03 02:25:28
synchronisiert	dubbed		
T-Shirt (n)	T-shirt		
Tabak (m)	tobacco		
Tablette (f)	tablet		
Tafel (f)	board		
Tagesgericht (n)	today's special		due@2021-10-08 22:40:26
Tagesschau (f)	television news		
Tagesschau (f)	television news		
Tankstelle (f)	petrol station, service station		
Tante (f)	aunt		
tanzen	to dance		
tapfer	brave		
Tasche (f)	bag		
Tasche (f)	bag		
Tasche (f)	bag, pocket		due@2021-10-08 22:40:01
Taschengeld (n)	pocket money		
Taschenlampe (f)	torch		
Taschenrechner (m)	pocket calculator		
Taschentuch (n)	handkerchief		
Tasse (f)	cup		
Tasse (f)	cup		
Tastatur (f)	keyboard		
tatsächlich	actually		due@2021-10-08 22:37:47
tauchen	to dive	deck#2	due@2021-10-03 03:41:18
Taxi (n)	taxi		
Taxifahrer/in (m/f)	taxi driver		
Tee (m)	tea		
Teil (m)	part		
teilen	to share		
Telefonat (n)	telephone call		due@2021-10-08 22:37:35
telefonieren	to telephone		
Telefonzelle (f)	telephone box	deck#2	due@2021-10-03 02:25:40
Teller (m)	plate		
Temperatur (f)	temperature	deck#2	due@2021-10-09 22:34:30
Temperatur (f)	temperature		
Tennisplatz (m)	tennis court		
Teppich (m)	carpet		
Teppichboden (m)	fitted carpet, wall-to-wall carpeting		
Termin (m)	appointment	deck#2	due@2021-10-03 03:42:55
Termin (m)	appointment		
Terrasse (f)	patio, terrace		
teuer	expensive		
Textbuch (n)	text book		
Theaterstück (n)	play		
Thunfisch (m)	tuna		
tief	deep		
Tiefkühltruhe (f)	freezer		
Tier (n)	animal	deck#2	due@2021-10-09 22:39:52
Tierart (f)	animal species	deck#2	due@2021-10-03 02:23:46
Tiergarten (m)	zoo		
tippen	to type		
Tischdecke (f)	table cloth		
Tischdecke (f)	tablecloth		
Toast (m)	toast		
Tochter (f)	daughter		
Tod (m)	death		
Toilette (f)	toilet		
toll	mad, crazy		
Tomate	tomato		
Tomate (f)	tomato		due@2021-10-02 02:24:18
Topf (m)	saucepan, pot		
Tornado (m)	tornado		
Torte (f)	gateau, flan		
tot	dead		
total	really (extremely)		
töten	to kill		due@2021-10-08 22:41:22
Tourist/in (m/f)	tourist		
Touristenbüro (n)	tourist office		
tragen	to wear	deck#2	due@2021-10-09 22:32:58
Trainingsanzug (m)	tracksuit		
Trainingsanzug (m)	tracksuit		
Traube (f)	grape		
traurig	sad		
traurig	sad		
traurig	sad		
treffen	to meet		
treffen	to meet		
treffen	to meet (by prior arrangement)		
treffen	to meet up		
Treibhauseffekt (m)	greenhouse effect		
Treppe (f)	stairs		
Trickfilm (m)	cartoon		
trinken	to drink		
trinken	to drink		
trinken	to drink		
Trommel (f)	drum		
Trompete (f)	trumpet	deck#2	due@2021-10-09 22:38:26
tschüss	bye		
Tür (f)	door		
Tür (f)	door		
Türke	Turk	deck#2	due@2021-10-09 22:35:03
Turm (m)	tower	deck#2	due@2021-10-03 03:41:00
Turnen (n)	gymnastics	deck#2	due@2021-10-03 02:21:41
Turnen (n)	PE		
Turnhalle (f)	gym		
U-Bahn (f)	underground, tube		
U-Bahn (f)	underground, tube		
übel	bad, nauseous		
üben	to practise		due@2021-10-08 22:37:36
übergeben (sich)	to be sick, to vomit		
überhaupt, gar	at all, anything		
überholen	to overtake	deck#2	due@2021-10-03 03:41:20
übernachten	to spend the night, stay		
überqueren	to cross		
Überschwemmung (f)	flood		
Übung (f)	exercise		
Uhr (f)	watch, clock		
umarmen	to hug, embrace		
Umkleideraum (m)	changing room		
umsteigen	to change		due@2021-10-08 22:34:40
Umwelt (f)	environment		
umweltbewusst	environmentally aware		
umziehen (sich)	to change (clothes)		
unabhängig	independent		
unartig	naughty		
Unfall (m)	accident		
Unfall (m)	accident		
unhöflich	rude, impolite		
Universität (f)	university		
unmöglich	impossible		
uns	us		
unsichtbar	invisible		
Unterkunft (f)	accommodation		
Unterricht (m)	lesson		
unterschiedliche	different		
untersuchen	to examine		
Untersuchung (f)	examination		due@2021-10-08 22:38:09
unterwegs	on the road		
Urlaub	vacation		
Urlaub (m)	holiday		
Valentinstag (m)	Valentine's Day	deck#2	due@2021-10-03 03:42:46
Vater (m)	father		
Vati (m)	dad	deck#2	due@2021-10-03 02:25:57
vegatarier	vegetarian		
Vegetarier/in (m/f)	vegetarian		
Vegetarier/in (m/f)	vegetarian		
Verabredung (f)	appointment		
verbessern	to improve, to correct		
verbringen	to spend (time)		
verdienen	to earn		
verfügbar	available		
vergessen	to forget		
vergessen	to forget, to leave behind		
verheiratet	married		
verkaufen	to sell		
Verkäufer/in (m/f)	sales assistant, shopkeeper		
Verkäufer/in (m/f)	sales, shop assistant		
Verkehr (m)	traffic		
Verkehr (m)	traffic		
Verkehr (m)	traffic		
Verkehrsampel (f)	traffic light		
Verkehrsamt (n)	tourist office		
Verkehrsmittel (n)	means of transport		
Verkehrsstau (m)	traffic jam		
verlassen	to leave (a place)	deck#2	due@2021-10-03 02:25:48
verletzen	to injure, to hurt, to wound		
verletzt	injured		
verliebt sein	to be in love		
verlieren	to lose	deck#2	due@2021-10-03 02:21:48
verlieren	to lose		
verlieren	to lose		
Verlobte (m/f)	fiancé(e)		
Verlobung (f)	engagement		
Verlust (m)	loss		
verpassen	to miss (train, bus)		
verpflichtet	obliged		
verschmutzt	polluted		
verschreiben	to precribe		
verspätet	delayed		
Verspätung (f)	delay		
verstopft	constipated		
Verwandte (pl)	relatives		
Verwandtschaft (f)	relations, relatives		
verwöhnt	spoilt		
viele	many		
vielleicht	might		
vier	four		
vierte	fourth		
Viertel (n)	district, quarter		
vierzig	fourty		
voll gar	well cooked, well done		
völlig	entirely		
Vollpension (f)	full board		
volltanken	to fill up (with fuel)		
vom Aussterben bedroht	endangered (species, plants etc)		
von	from, of		
voraus	ahead		
Vorbereitungen (pl)	preparations		due@2021-10-08 22:41:16
Vorfahrt (f)	right of way, priority		due@2021-10-08 22:40:52
vorhaben	to intend to	deck#2	due@2021-10-03 03:42:45
Vorhang (m)	curtain		
Vorname (m)	first name		
Vorname (m)	first name		
Vorort (m)	suburb		
Vorspeise (f)	starter		
Vorstadt (f)	suburb(s)		
vorstellen	to introduce		
Vorstellung (f)	performance, showing		
Vorstellung (f)	show, performance		
Vorstellungsgespräch (n)	interview		
vorzeigen	to show		
vorziehen	to prefer		due@2021-10-08 22:34:37
Waffel (f)	waffle		
Wagen (m)	car		
wählen	to choose		
wählen	to dial		
Wand (f)	wall (internal, inside)		
wandern	to hike, to go rambling		
wann	when	deck#2	due@2021-10-09 22:33:31
Warenhaus (n)	department store		
warm	warm	deck#2	due@2021-10-09 22:37:55
warten	to wait		
Warteraum (m)	waiting room		
Wartesaal (m)	waiting room		
warum	why		
Waschbecken (n)	washbasin		
wäschen	to wash		
waschen (sich)	to wash		
Waschmaschine (f)	washing machine		
Wasser (n)	water		
Wasserhahn (m)	tap		
Wasserpark (m)	water park		
Wasserski (m)	waterskiing		
Wasserski fahren	to waterski		
Website (f)	website		
Wechsel (m)	change		
wechseln	to change		
wechseln	to change		
Wechselstube (f)	bureau de change		
Wechselstube (f)	bureau de change		
wecken	to wake (someone)		
Wecker (m)	alarm clock		
weder	neither		
weg	away		
weh tun (sich)	to hurt (oneself)		due@2021-10-08 22:37:51
weich	soft		
weiche Drogen	soft drugs		
Weihnachten (n)	Christmas		due@2021-10-08 22:37:39
Weihnachtsbaum (m)	Christmas tree		
Weihnachtsmann (m)	Father Christmas		
weil	because		
Wein (m)	wine		
weinen	to cry		
weiße	white		
Weißes Haus (n)	White House		
Weißwein (m)	white wine		
weit	far		
weiterfahren	to continue, drive on		
welche	which		
Welle (f)	wave		
Welt (f)	world		
Weltraum (m)	space		
wen	whom		
wenden	to turn		
Werbespot (m)	advertisement, advert		
Werbung (f)	advertisement, advertising		
werfen	to throw		
Werkzeug	tool		
West (m)	west		
Wetter (n)	weather		
Wetterbericht (m)	weather report		
Wettervorhersage (f)	weather forecast		
wichtiger	more important		
wie	how, like		
wie geht's?	how are you?		
wie komme ich...?	How do I get (to ...)?		
wie viel(e)	how much, how many		
wie viel(e)	how much, how many		
wieder, erneut	again		
wiederholen	to repeat		
willkommen	welcome		
Willkommen (n)	welcome		
willkommen heißen	to welcome		
Wind (m)	wind		
windig	windy		
Windsurfbrett (n)	windsurfing board		
windsurfen	to windsurf		
wir	we		
wirklich?	really?		
wissen	to know		
wissen	to know		
wo	where		
wofür	for what		
woher	where from		
wohin	where to		
wohnen	to live		
wohnen	to live		
Wohnung (f)	flat		
Wohnzimmer (n)	sitting room, living room		
Wolke (f)	cloud		
wolkig	cloudy		
wollen	to want to, to wish to		
Wort (n)	word		
Wörterbuch (n)	dictionary		
wünschen	to wish		
Wurst (f)	sausage		
Würstchen (n)	little sausage, frankfurter sausage, hot dog		
Wüste	desert		
Zahn (m)	tooth		
Zahnarzt/-ärztin (m/f)	dentist		
Zahnarzt/Zahnärztin (m/f)	dentist		
Zahnbürste (f)	toothbrush		
Zahnschmerzen (pl)	toothache		
Zehe (f)	toe		
zeichnen	to draw		
zeichnen	to draw	deck#2	due@2021-10-03 02:24:05
zeigen	to show		
Zeitraum (m)	period (of time)		
Zeitung (f)	newspaper	deck#2	due@2021-10-09 22:38:32
Zeitungskiosk (m)	newspaper kiosk/stand		
Zelt (n)	tent	deck#2	due@2021-10-03 02:24:12
Zeremonie (f)	ceremony		
zerstören	to destroy		
Zeugnis (n)	report		
Zigarette (f)	cigarette		
Zimmer (n)	room		
Zirkus (m)	circus		
Zitrone (f)	lemon		
Zoll (m)	customs		
Zoo (m)	zoo		
Zoowärter/in (m/f)	zoo keeper		
zu	to, too		
zu den Akten legen	to file away		
zu Ende gehen	to come to an end	deck#2	due@2021-10-03 02:21:49
zu Fuß	on foot		
zu Hause	at home		
Zucker (m)	sugar		
Zug (m)	train		
zuhören	to listen		
zuhören	to listen		
Zukunft (f)	future		
zuletzt	last of all		
zunehmen	to put on weight		
Zunge (f)	tongue		due@2021-10-08 22:40:53
zusammen	together		
zwanzig	twenty		
zwei	two		
zweiundachtzig	eighty two		
zweiunddreißig	thirty two		
Zwiebel (f)	onion		
Zwilling (m)	twin		
#--decks immediate,daily,weekly,monthly,quarterly,yearly
#--intervals 0,1440,10080,43200,129600,518400
#--columns column#1,column#2
#--showcolumns column#1
#--showcolumns column#2
