15 Αυγούστου	August 15
26 Δεκεμβρίου	December 26, second day of Christmas
28 Οκτωβρίου	National holiday about the famous No to the invasion of the Italians in WW2
e-mail	email
άγγελος	angel
αγγίζω	to touch
Αγγλία	England
αγγλικά	English
αγγλικός	English (origin)
αγγούρι	cucumber
αγελάδα	cow
αγενής	rude; unkind
άγιος	saint
Αγίου Πνεύματος	Holy Spirit
αγνωστικιστής	agnostic
άγνωστος	unknown
αγορά	purchase
αγοράζω	to buy
αγόρασε	he/she/it bought
αγόρι	boy
αγρόκτημα	farm; farmland
αγρότης / αγρότισσα	farmer
αγώνα	match
αδελφή	sister
αδιάκριτος	indiscreet
αδύναμος	weak; powerless
αδύνατος	thin
αέριο	gas
αεροδρόμιο	airport
αεροπλάνο	airplane
αεροπορικός	air, aerial
αεροσυνοδός	flight attendant
αετός	eagle
άθεος	atheist
αθροίζω	to sum, add up, tot up, cast; to assemble
αιγυπτιακός	Egyptian (origin)
Αίγυπτος	Egypt
αίτημα	request
αιτία	cause, reason
αιώνα	century
αιώνας	century
αιώνια/αιωνίως	eternally, forever, everlastingly
ακαδημία	academy
ακολουθώ	to follow
ακόμα	still/yet
ακριβό	expensive
ακροβάτης / ακροβάτισσα	acrobat
ακτή	coast, shore
ακτίνα	radius
αλεπού	fox
αλήθεια	truth
αλλά	but
αλλάζω	to change
αλλιώς	otherwise
άλλος	other, another
άλλοτε	once/another time
άλογο	horse
αλυσίδα	chain
αμερικανικός	American (origin)
Αμερική	America (the continents of North and South America)
άμεσα	directly
αμέσως	immediately; instantly
αμφιβάλλω	to doubt
αν	if / whether
ανά	a; per
ανάβω	turn on the light
αναγνωρίζω	to recognise
αναζητώ	to search for
ανακάλυψη	discovery
ανακύκλωση	recycling
ανάλυση	analysis
αναλυτικός	analytical
ανάμεσα	between
αναπολώ	to look back; to reminisce
ανατολή	east; sunrise; Orient
ανατολικά	east; eastward; eastwards
ανατρέφω	to raise
αναφέρομαι	to refer to
αναφέρω	to mention
ανεβαίνω	to climb; to go up
ανεβάσω	to upload
ανεξιθρησκεία	religious tolerance
ανήκω	to belong
ανησυχώ	to worry
ανθρώπινος	human
άνθρωπος	human/person
ανόητος	silly
ανοίγω	turn on / open
άνοιξη	spring
Άνοιξη	spring
ανοιχτός	light (color)
ανοιχτόχρωμος	light-colored
αντικείμενο	belonging; object
αντίο	goodbye
αντιπαθητικός	unlikeable; unlikable
αντίσταση	resistance
αντωνυμία	pronoun
ανώτατος	supreme
αξίζω	to deserve; to be worth
αξιοματικός	officer
αξιωματικός	officer
απαγορεύω	to forbid
απαίσιος	awful; terrible
απάντηση	answer
απαντώ	to answer; to reply
άπειρη	infinite
απενεργοποιώ	to deactivate
από	from
από ό,τι	than
απόγευμα	afternoon
αποδέχομαι	to accept
αποδοτικός	efficient
αποθήκη	storage room; storeroom; pantry; warehouse
απόλυτα/απόλυτος	absolutely
απόλυτος	absolute
απορρίπτω	to reject; to turn down
αποσκευή	luggage
αποσμητικό	deodorant; anti-perspirant; freshener
απόσταση	distance
αποσύνδεση	logout
αποταμίευση	saving
αποτυγχάνω	to fail
αποφοίτηση	graduation
απόψε	tonight
Απρίλιος / Απρίλης	April
άρα	so; thus; therefore
Αραβία	Arabia
αράχνη	spider
αργά	slowly; late
αργότερα	later
αρετή	virtue
άρθρο	article
αριθμός	number
αριστερός	left
άριστος	excellent
αρκετά	quite; enough
αρκετός	enough
αρκούδα	bear
αρνητικός	negative; disapproving
αρνούμαι	to refuse; to deny
αρχαίος	ancient
αρχή	beginning; start; origin
αρχηγός	leader
αρχιτέκτονας	architect
ασήμι	silver
Ασία	Asia
ασιατικός	Asian (origin)
ασπίδα	shield
αστείος	funny
αστυνομία	police
αστυνομικός / αστυνόμος	policeman / policewoman
άσχημος	ugly
άτομο	individual/person
Αύγουστος	August
αυξάνω	to increase, raise, put up; to augment
αύξηση	increase
αύριο	tomorrow
Αυστραλία	Australia
αυτή	she
αυτοκίνητο, αμάξι	car
αφαίρεση	subtraction
αφεντικό	boss
αφήνω	to leave
αφού	since; after
αφρικανικός	African (origin)
Αφρική	Africa
αχλάδι	pear
βάζω	to put
βάθος	depth
βαθύ	deep; dark
βαθύς	high, deep
βαριέμαι	to be bored
βάρκα	boat
βάρος	weight
βαρύς	heavy
βασίζω	to base
βασικός	basic
βασιλιάς	king
βγαίνω	to go out
βέβαια	constantly
βεβαίως	certainly, of course
βελόνα	needle
βέλος	arrow
βελτιώνω	to improve; to make better
βενζίνη	gasoline
βήτα	beta
βιβλίο	book
βίντεο	video
βιντεοκλήση	video call
βιολετί	violet
βιομηχανία	industry
βλέπω	to see
βοηθώ	to help
βόρεια	north; to the north of
βορειοανατολικά	northeast
βορειοδυτικά	northwest
βουβάλι	buffalo
βουνό	mountain
βραβείο	prize
βράδυ	evening; night (early)
Βραζιλία	Brazil
βρακί	pants
βρέχει	it rains
βρέχω	to rain
βρήκα	I found
βρίσκω	to find
βρύση	faucet; tap
βρώμικος	dirty
βυσσινί	crimson red
γάλα	milk
γαλάζιο	light blue; blue
γαλάζιος	light blue
γαλαζοπράσινο	aquamarine
γαλλικά	French (language)
γαλλικός	French (origin)
γάμος	wedding
γάντι / γάντια	glove / gloves
γάτα	cat
γεγονός	fact; event
γειτονιά	neighborhood
γελώ	to laugh
γεμίζω	to fill
γενιά	generation
γενικά	generally; in general; all in all
γενικός	general; generic
γενναιόδωρος	generous
γενναίος	brave
γέννηση	birth
γεράκι	hawk
Γερμανία	Germany
γερμανικός	German (origin)
γέρος	old man
γεύμα	meal
γία	about
για να	in order to
γιαγιά	grandma
γιατί	why / because
γιατρός / ιατρός	doctor
γίνομαι	happen
γιορτή	celebration
γιώτα	yiota
γκρι	grey
γλέντι	revelry; party; feast
γλυκό	sweet
γλύπτης / γλύπτρια	sculptor
γλώσσα	language
γνωρίζω	to introduce
γόμα	rubber; eraser
γονέας, γονιός	parent
γραβάτα	tie
γραμμάριο	gram
γραμματέας	secretary
γραμματόσημο	postage stamp
γραφίστας / γραφίστρια	graphic designer
γράφω	to write
γρήγορα	fast, quickly
γρήγορος	fast
γρήηορος	fast
γριά	old woman
γυμναστήριο	gym
γυναίκα	woman/wife
γωνία	angle
δαμασκηνί	plum purple
δάνειο	loan
δάσκαλος	teacher
δάσκαλος / δασκάλα	teacher (elementary school)
δάσος	forest
δείγμα	sample
δείπνο	dinner
δεισιδαιμονία	superstition
δείχνω	to point
Δέκα	10
Δεκαεννιά	19
Δεκαέξι	16
δεκαετία	decade
Δεκαεφτά	17
Δεκαοχτώ	18
Δεκαπέντε	15
Δεκατέσσερα	14
Δεκατρία	13
Δεκέμβριος / Δεκέμβρης	December
δελφίνι	dolphin
δερμάτινος	leather
Δευτέρα	Monday
Δευτέρα του Πάσχα	Day after Easter
δευτερόλεπτο	second
δεύτερος	second
δέω	to make possible
δηλαδή	in other words; so; that is
δημοφιλής	popular
διαβάζω	to read; to study
διαγραφή	deletion
διαγωνισμός	contest
διαδίκτυο	internet
διαδρομή	route; commute; way; path
διάδρομος	corridor; hallway
διαθέσιμος	available
διαίρεση	division
διακόπτω	to interrupt, disrupt, stop; to terminate, discontinue, break off
Διακόσια	200
διαλεκτικός	dialectic
διαμάντι	diamond
διαμέρισμα	apartment
Δίας	Zeus
διάσημος	famous; well known
διάσταση	dimension
διάταγμα	decree
διατηρώ	to keep; to maintain
διαφήμιση	advertisement
διαφορετικά	different
διαφορετικός	different
διαφωτισμός	Enlightenment
διεθνές	international
διεθνής	international
διεύθυνση	address; direction
διευθυντής	principal; director
διευθυντής / διευθύντρια	manager; director / principal (school)
δικαιολογημένος	reasonable
δικαίωμα	right
δικαστής	judge
δίκη	own
δικηγόρος	lawyer
δίκτυο	network
διόδια	tollbooth
διοικητής	commander; governor
δίπλα	next to
διπλανός	next; adjacent
διπλός	double
δις	twice
δοκιμάζω	to try
δολάριο	dollar
δομισμός	structuralism
δόρυ	spear
δουλειά	job
δουλεύω	to work
δράκος	dragon
δραστηριότητα	activity
δρόμο	road
δρόμος	road
δυνατός	strong; powerful; possible
Δύο	2
δύο φορές / δις	twice
δύση	west; sunset
δύσκολος	difficult
δυστυχώς	unfortunately
δυτικά	west; westwards
Δώδεκα	12
δώρο	gift
δώσω	I will give
εαυτός	self
εβδομάδα	week
Εβδομήντα	70
εγώ	I
Εγώ είμαι ο / η ...	I am ...
Εγώ μένο στην ...	I live in ...
εγωιστής	selfish; egoist
έδειξα	I showed
εδώ	here
εθνικότητα	nationality
είδε	he/she/it saw
ειδικά	especially, specifically
ειδοποιώ	to notify
είδος	type, genre
Είκοσι	20
ειλικρινά	honestly
Είμαι καλά	I am well; I am fine
ειρήνη	peace
εισιτήριο	ticket
είτε ... είτε	either... or
είχε	had
Εκατό	100
εκατομμύριο	million
εκατοστός	centimeter; centimetre
εκδοτήριο	ticket booth
εκεί	there
εκείνο	that
εκκλησία	church
έκπτωση	sale, discount
εκρού	ecru
έκτακτα	great
εκτάτκως	without planning in advance
ελαιόλαδο	olive oil
ελαφρύς	light
ελέγχω	to control
ελέφαντας	elephant
ελιά	olive; olive tree
ελικόπτερο	helicopter
Ελλάδα	Greece
Ελληνικά	Greek
ελληνικός ποιμενικός	Greek Shepherd
ελπίζω	to hope
εμπειρία	experience
εμπιστεύομαι	to trust
εμποδίζω	to prevent; to stop; to block the way; to obstruct the way
εμπορικός στόλος	merchant navy; merchant fleet
εμπόριο	trade
έμπορος	merchant
Ένα	1
ένα	one
Ένα δισεκατομμύριο	1000000000
Ένα εκατομμύριο	1000000
εναντίον	against
ένας, μία, ένα	one, a/an
ενδιαφέρουσα	interesting
ενδιαφέρων	interesting
Ενενήντα	90
ενέργεια	energy
ενεργός	active
Εννιά	9
Εννιακόσια	900
εννοώ	mean, signify
ενοίκιο	rent
Εντάξει	ok; fine; alright
Έντεκα	11
έντομο	insect
ενώ	while; whereas
εξαιρετικός	excellent; great
εξαιτίας	due to
Εξακόσια	600
εξαφανίζω	to disappear; to vanish; to be missing
Εξήντα	60
Έξι	6
έξυπνος	smart; clever
έξω	outside
επάγγελμα	profession
επαγγελματίας	professional
επανάσταση	revolution
επείγων	urgent; an emergency
επειδή	because; since
επειδή, γιατί, διότι	because
επηρεάζω	to affect
επίθετο	adjective
επικίνδυνος	dangerous
έπιπλο	piece of furniture
επίρρημα	adverb
επίσημος	official; formal
επισκέπτομαι	to visit
επιστήμη	science
επιστήμονας	scientist
επιστρέφω	to return
επιταγή	check
επιτέλους	finally
επιτρέπω	to allow
επιτροπή	committee
επιτυχία	success
επιφάνεια	surface
επιφώνημα	interjection
επιχείρηση	business
επόμενος	next
εποχή	season
εργαστήριο	laboratory
εργάτης / εργάτρια	worker
Εργατική Πρωτομαγιά	May First, Labor Day
εργένης	bachelor
εργοστασιάρχης / εργοστασιάχρισσα	industrialist
ερπετό	reptile
έρχομαι	to come
εσύ	you
εσωτερικό	interior
εταιρεία	company
ετκός	except
έτοιμος	ready
έτσι	like so/so
ευγενικός	kind; polite
ευθεία	straight line; straight
ευθύς	direct, straight, straightforward, candid
εύκολα	easily, easy
εύκολος	easy
ευρύς	wide
ευρώ	euro
ευρωπαϊκός	European (origin)
Ευρώπη	Europe
ευτυχία	happiness
ευτυχώς	fortunately
ευχάριστα	nicely
Ευχαριστώ!	Thank you!
ευχαρίστως	with pleasure
εύχομαι	to wish
εφαρμογή	application
εφεύρεση	invention
εφευρέτης / εφευρέτρια	inventor
Εφτά	7
Εφτακόσια	700
εχθρός	enemy
ζακέτα	sweater
ζάχαρη	sugar
ζέβρα	zebra
ζευγάρι	couple; pair
ζουζούνι	insect
ζυγίζω	to weigh
ζυμαρικά	pasta; macaroni
ζω	to live
ζωή	life
ζώνη	belt
ζώο	animal
ζωολογικό κήπο	zoo
ή	or
η αλυσίδα	the chain
η αυλή	the yard
η βιβλιοθήκη	the library; the bookcase
Η Γαλλία	France
η γωνία	the corner; the angle
η Εκκλησία	the church
η ζάχαρη	the sugar
η ζέστη	the heat
Η Ισπανία	Spain
η κάμερα	the camera
η καμπάνα	the bell
η καρέκλα	the chair
η κήπος	the garden
Η Κίνα	China
η κότα	the hen
η κοτόπιτα	chicken pie
η κουζίνα	the kitchen/the stove
η κούπα	the cup
η κουρτίνα	the curtain
η κρεατόπιτα	meat pie
η κρεβατοκάμαρα / το υπνοδωμάτιο	the bedroom
η λάμπα	the lamp
η μηχανή	the engine
η μπανιέρα	the bathtub
η μπαταρία	the battery
η μύτη	the nose
η ντουλάπα	the closet / the wardrobe; the locker
η νύχτα	the night
η οδοντόβουρτσα	the toothbrush
η ομπρέλα	the umbrella
η πάπια	the duck
η παραλία	the beach
η πατάτα	the potato
η πετσέτα	the towel
η πισίνα	the swimming pool
η πίτσα	the pizza
η πολυθρόνα	the armchair
η σερβιτόρα	the waitress
η σημαία	the flag
η σκάλα	the ladder
η σπανακοτυρόπιτα	spinach and cheese pie
η τηλεόραση	the TV
η τραπεζαρία	the dining room
η τσάντα	the bag
η φάρμα	the farm
η φασολάδα	bean soup
η φυλακή	the prison
η χελώνα	the turtle
η χτένα	the comb
ήδη	already
ηδονή	pleasure
ηθική	morality
ηθοποιός	actor / actress
ηλεκτρίκ	electric blue
ηλεκτρισμός	electricity
ηλεκτρολόγος	electrician
ηλεκτρονικό υπολογιστή	computer
ηλικία	age
ηλικιωμένος	old person
ημέρα	day
ήμερα	day
Ημέρα Ανεξαρτησίας	March 25, Independence Day
ημέρα, μέρα	day
ημερολόγιο	calendar
ΗΠΑ	USA
ήπειρος	continent
ήσυχος	quiet
ήττα	defeat
ήχος	sound
θα μπορώ	could
θάλασσα	sea
θαλασσί	sea/ocean blue
θάνατος	death
θάρρος	dare
θεάσεις	views
Θεέ!	Oh my god!
θέλω	to want
Θεοφάνεια	January 6, Epiphany
θερμοκρασία	temperature
θετικισμός	positivism
θετικός	positive
θεωρία	theory
θεωρώ	to consider; to think; to repute
θησαυρός	treasure
θρησκεία	religion
θρόνος	throne
θύμα	victim
θυμάμαι	to remember
θυρωρός	doorkeeper
Ιανουάριος / Γενάρης	January
Ιαπωνία	Japan
ιατρικός	medical
ιδαίτερα	a lot, much
ιδέα	idea
ίδια μου	myself
ιδιαίτερος	special
ιδιαιτέρως	privately
ίδιο	same
ίδιοι	the same; alike
ιδιοκτησία	property; ownership
ιδιωτικός	private
ίδρυμα	institute; institution; foundation
ιδρυτής	founder
ιερός	sacred
ιλιάδα	Iliad
Ινδία	India
Ινδουισμός	Hinduism
Ιουδαίος	Jew
Ιουδαϊσμός	Judaism
Ιούλιος	July
Ιούνιος	June
ιππότης	knight
Ιρλανδία	Ireland
ιστοσελίδα	website
ίσως	maybe
Ιταλία	Italy
ιταλικός	Italian (origin)
κάβουρας	crab
καβούρι	crab
Καθαρά Δευτέρα	First Day of Lent, Clean Monday
καθαρίζω	clean
καθαριστής	cleaner
καθαρός	pure; clean; clear
κάθε	every, each
κάθε μέρα	every day; everyday
καθένας, καθεμία, καθένα	each, every
καθετί	everything
καθηγητής / καθηγήτρια	professor; teacher (middle school & university)
καθολικός	Catholic
κάθομαι	to sit
και / κι	and
και μισή / και δυόμιση	thirty / half past
καλάθι	basket
καλαμάκι	straw
καλή όρεξη	bon appetit
καλημέρα	Good morning
καληνύχτα / καλό βραδύ	good night
καλλιτέχνης	artist
καλοκαίρι	summer
Καλοκαίρι	summer
καλοριφέρ	radiator
κάλτσα / κάλτσες	sock / socks
καλύτερος	better
καλώ	to call
καμήλα	camel
καμηλοπάρδαλη	giraffe
καμπάνα	bell; bell-bottomed trousers
κάμποσος	enough, some
καναπές	sofa
καναρινί	canary yellow
κανείς/κανένας, καμία, κανένα	no one/nobody, anyone/anybody, no
κανελί	cinnamon red
κανόνι	cannon
κάνω	to do
καπέλο	hat
καπετάνιος	captain
κάποιες φορές	sometimes
κάποιος	some; someone/somebody
κάποτε	once/sometimes
κάπως	somehow
καρέκλα	chair
καριέρα	career
καρπούζι	watermelon
καρπουζί	watermelon red
καρχαρίας	shark
κασκόλ	scarf
καστανό	(chestnut) brown
καστανός	brown (esp. hair/eyes)
κάστρο	castle
κατάγεται	to come from
κατάθλιψη	depression
καταλαβαίνω	to understand
κατεβάζω	to download
κατεβαίνω	to go down; to come down
κατευθύνομαι	to head towards
κατεύθυνση	direction
κάτι, κατιτί	something
κατοικίδιο	pet
κατοικώ	live / reside
κατσαρόλα	pot; cooking pot
κάτω από	under
καύσιμο	fuel
καφέ	brown
καφές	coffee
καφετέρια	cafe; coffee shop
κέικ	cake
κείμενο	text
κέντρο	center; centre
κεραμιδί	brick red
κεραμικό	ceramic
κεράσι	cherry
κερδίζω	to beat; to defeat; to win
κεφάλαιο	chapter
κεφτές	meatball
κήπο	garden
κιλό	kilo
κινέζικος	Chinese (origin)
κινηματογράφος	movies; cinema; movie theater
κίνηση	traffic
κινητό	cell phone
κίτρινος	yellow
κλαίω	to cry, weep; to water, run; to mourn, grieve for; to feel sorry for
κλάσμα	fraction
κλειδί	key
κλείνω	to close; to book
κλείνω / σβήνω	turn off
κλειστός	closed
κλήρωση	drawing
κλικάρω	to click
κλινικός	of or pertaining to a bed
κλωστή	thread; string
κόβω	to cut
κοιλάδα	valley
κοιμάμαι	to sleep
κοιμάται	he/she/it sleeps
κοινό	public; viewers; crowd
κοινοβούλιο	Parliament
κοινοποίηση	share
κοινωνικός	social; sociable
κοιτάζω	to look
κοκκινομάλλα	redhead
κόκκινος	red
κολλητός	best friend
κολλητός/κολλητή	best friend
κολυμπάω	to swim
κολυμπώ	to swim
κομμάτι	a piece of
κομμωτής / κομμώτρια	hairdresser
κοντά	near
κοντομάνικο	T-shirt
κοντός	short
κοπέλα	girlfriend
κοραλί	coral pink
Κορέα	Korea
κόρη	daughter
κορίτσι	girl
κορυφή	top
κόσμημα	jewel
κοσμήματα	jewelry
κοστίζω	to cost
κόστος	cost
κοστούμι	suit
κότα	hen
κουβέρτα	blanket
κουκουβάγια	owl
κουλτούρα	culture
κουμπαρά	moneybox; piggy bank
κούπα	cup
κουράζω	
κουράζω	to tire
κουρασμένος	tired
κουτάβι	puppy
κουτάλι	spoon
κουτί	box
κουφετί	candy pink
κράνος	helmet
κρασί	wine
κρατάω	to hold
κρατέω	to look after; to mind
κρατώ	to keep; to hold
κρέας	meat
κρεμμύδι	onion
κρεοπώλης / κρεοπώλισσα	butcher
κρίση	crisis
κρύσταλλος	crystal
κτηνίατρος	vet
κτηνοτρόφος	livestock-breeder
κτήριο	building
κτίριο	building
κύβος	cube
κύκλος	circle
κύπελλο	cup
Κύπρος	Cyprus
κυριά	madam/mrs
Κυριακή	Sunday
κύριος	sir/mr
κωμόπολη	town
λαγός	hare
λαδί	olive green
λαός	people
λαχανής	lime green
λαχανί	light green; cabbage green
λεμόνι	lemon
λεμονί	lemon yellow
λέξη	word
λεπτό	minute
λεπτομέρεια	detail
λεωφορείο	bus
λεωφόρο	avenue
λεωφόρος	avenue
λιακάδα	sunshine
λίγο	some; a little
λίγο από	a bit of
λιγότερα	fewer
λιγότερο	less
λιλά	lilac
λιμάνι	port
λιοντάρι	lion
λίτρο	liter
λογαριασμός	account
λογική	logic
λογιστής / λογίστρια	accountant
λοιπόν	well; so
λουκάνικο	sausage; wiener; hot dog
λουλούδι	flower
λύκος	wolf
λυπάμαι	I am sorry
λυπάμαί	Sorry
μάγειρας / μαγείρισσα	chef
μαγειρεύω	to cook
μαγειρική	cooking; cookery
μαγικός	magic
μάγος	wizard
μαζί	together
μαθητής / μαθήτρια	student (school)
μάθω	to learn
Μάιος / Μάης	May
μακριά	far; long; away
μακρύς	long
μαλλιά	hair
Μάλτα	Malta
μαραθώνιος	marathon
μάρκα	brand
μάρμαρο	marble
Μάρτιος / Μάρτης	March
μάταια/ματαίως	in vain
μαχαιροπίρουνα	cutlery; flatware; silverware
μάχη	battle
Με συγχωρείτε	Excuse me
Μεγάλη Παρασκευή	Holy Friday
Μεγάλο Σάββατο	Holy Saturday
μεγάλος	big
μεγαλώνω	to bring up, raise; to enlarge; to grow, develop
μεθαύριο	the day after tomorrow
μέθοδο	method
μέθοδος	method
μεθώ	to get drunk, become intoxicated
μείωση	decrease
μελαχρινός	dark-haired; brunette
μελετάω	to study
μελετώ	to study
μελί	honey brown
μέλισσα	bee
μελισσοκόμος	beekeeper
μελιτζανί	eggplant purple
μέλλον	future
μενού	menu
μένω	to stay, wait; to await, expect
Μεξικό	Mexico
μέρα	day
μερικές φορές	sometimes
μερικοί, μερικές, μερικά	some
μερικός	partial/part time
μέρος	place; part
μέρχι	until
μέσα	in; inside
μέσα μαζικής μεταφοράς	public transport
μεσάνυχτα	midnight
μεσημεριανό	lunch
μέσος	average; middle
μετά	then, after
μεταφραστής / μεταφράστρια	translator
μετενσάρκωση	reincarnation
μετοχή	participle
μέτρα	meter; measures
μετράω	to count; to measure
μετρό	subway
μέχρι	until
μη(ν)	prohibitive particle
Μηδέν	0
μήκος	length
μήλο	apple
μην	don't
μήνας	month
μήνυμα	message
μητέρα	mother
μηχανάκι	motorcycle
μηχανικός	engineer; mechanic
μία φορά	once
μικρός	little; small
μιλάω κινέζικα	I speak Chinese
μιλάω; μιλώ	to speak
μίλι	mile
μιλώ	to speak
μίνι μάρκετ	mini market
μισό	half
μνήμη	memory
μοίρα	degree, fate
μόλις	just; as soon as
μολύβι	pencil
μονάδα	unit
μοναστήρι	monastery
μονή	abbey
μονοπάτι	path
μόνος	the only one; only
μόριο	molecule
μουσείο	museum
μουσουλμάνος	Muslim
μουσταρδί	mustard yellow
μοχθηρός	evil
μπαίνω	to go into; to get into
μπαμπα	dad
μπαμπά	dad
μπαμπάς	dad
μπεζ	beige
μπερδεμένος	tangled; confused; tricky
μπλε	blue
μπλοκάρω	to block
μπλούζα	T-shirt
μπολ	bowl
μπορντό	bordeaux
μπορώ	to be able to
μπότα	boot
μπουφάν	jacket
μπριζόλα	steak
μπροστά	ahead; in front; front
μπροστινός	in front
μπύρα / μπίρα	beer
μυθιστόρημα	novel
μύθος	myth
μωβ	mauve; purple
μωρό	baby
να	to
ναι	yes
ναός	temple
ναύτης	sailor
νεαρός	young; young man
νεκρός	dead
νεκροταφείο	cemetery; graveyard
νεολαία	youth
νεολαίας	youth
νέος	young; new
νεροχύτης	sink
νικάω	to win
νίκη	victory
νικητής	winner
νιπτήρας	washbasin
νιώθω	to feel
Νοέμβριος / Νοέμβρης	November
νόημα	meaning
νοιάζει	to care; to care about
νοικιάζω	rent (from someone)
νομίζω	to think
νόμισμα	currency
νόμος	law
νονός	godfather
νοσοκόμος / νοσοκόμα	nurse
νότια	south; southwards
νοτιοανατολικά	southeast
νοτιοδυτικά	southwest
νταλίκα	trailer truck
ντουλάπα	closet; wardrobe
ντουλάπι	cabinet
ντουντούκα	megaphone
ντους	shower
ντύνω	to dress someone; to cover, upholster
νωρίς	early
ξάδελφος	cousin
ξανά	again
ξανθός	blonde
ξαφνικός	sudden, unexpected, unannounced
ξεκινώ	to start; to begin
ξεκουράζομαι	to rest; to relax
ξενοδοχείο	hotel
ξέρω	to know
ξεχνάω	to forget
ξίδι	vinegar
ξοδεύω	to spend
ξυράφι	razor; razor blade
ο αέρας	the wind
ο άντρας	the man
ο γύρος	slices of pork roasted on a spit and served with sauce and garnishes, such as tomato and onions on pita bread
ο δρόμος	the road
ο ήλιος	the sun
ο καιρός	the weather
ο καναπές	the sofa
ο καπετάνιος	the captain
ο μουσακάς	meat and eggplant casserole, topped with a savory custard which is then browned in the oven
ο νιπτήρας	the sink
ο ντάκος	Cretan salad consisting of a slice of bread or barley rusk / paximadi, topped with tomatoes and feta cheese
ο πύργος	the tower
ο σερβιτόρος	the waiter
ο σίδηρος	the iron
ο τοίχος	the wall
ο υπολογιστής	the computer
ο φούρνος	the oven
ο χαλκός	the copper
ο χρυσός	the gold
Ογδόντα	80
όγκος	volume; bulk
οδηγία	instruction; direction
οδηγός	driver
οδηγός ταξί	taxi driver
οδηγώ	to drive
οδοντόβουρτσα	toothbrush
οδοντόκρεμα	toothpaste
οδοντόπαστα	toothpaste
οθόνη	screen; monitor
οι μπότες	the boots
οικείος	familiar
οικογένεια	family
οικογενειακός	family
οικοδόμος	builder; construction worker
οικονομικό	financial
Οκτώβριος / Οκτώβρης	October
όλη την ώρα	all the time
Ολλανδία	the Netherlands, Holland
όλο	constantly/all the time
ολόκληρος	whole
όλος	all
ομίχλη	foggy; fog
όμορφος	beautiful
όμως	however; but
ον	being; entity; creature
ονειρεύομαι	to dream
όνομα	name
όντας	being
όπλο	gun, weapon
οπότε	therefore; and therefore; so
όποτε	whenever; when
όποτε/οποτεδήποτε	whenever
οπουδήποτε	anywhere
οπτιμιστής	optimist
όπως	as, like; however
οργανισμός	organization
Οργανισμός Ηνωμένων Εθνών	United Nations Organization
ορθογώνιος	rectangular
Ορθοδοξία	Orthodoxy
όριο	limit
ορισμός	Definition
ορίστε	here you are; here; here you go
ορκωμοσία	oath-taking
ορυκτό	mineral
όσο	however much
όταν	when
ουμανισμός	humanism
ουρανί	sky blue
ουσιαστικό	noun
ούτε	neither
ούτε ... ούτε	neither... nor
όχημα	vehicle
όχι	not, no
Οχτακόσια	800
Οχτώ	8
παγανισμός	paganism
παγκόσμιος	worldwide
παγωτό	ice cream
παιδαγωγός	educator
παίζω	to play
παίρνω	to take
παιχνίδι	game, toy
παλαιότερο	oldest
πάλι	again
παλιός	old
παλτό	coat
πανεπιστήμιο	university
πανηγύρι	fair
πάντα	always
παντελόνι	pants
παντού	everywhere
πάνω	on
πάνω κάτω	give or take
πάνω σε	on
παπάς	priest
πάπια	duck
παπούτσι / παπούτσια	shoe / shoes
παππούς	grandpa
πάρα	very
παραγγέλω	to order
παραδίδω	to deliver; to hand in
παράθυρο	window
παρακαλώ	please
to beg; to request; to plead with
παραλαμβάνω	to receive; to collect
παραμύθι	fairy tale
παράξενος	weird
Παρασκευή	Friday
παρέα	company; group of friends
παρελθόν	past
παρεμπτίπτω	to interfere
παρόν	present
παρούσα	present; current
παρουσιάζω	to present; to show
πάρτι	party
Πάσχα	Easter
πάτωμα	floor
παχαίνω	to gain weight; fatten
πάω	to go
πεζοδρόμιο	sidewalk
πει	told
πελεκάνος	pelican
πέμπτη	Thursday
Πέμπτη	Thursday
πέμπτος	fifth
Πενήντα	50
Πεντακόσια	500
Πέντε	5
πεπόνι	melon
πέρ(υ)σι	last year
περιέχω	to contain; to include; to have
περιμένω	to wait
περιοχή	area
περίπου	approximately; about
περισσότερο	more; more like
περισσότερος	more
περιστρέφω	to revolve; to spin; to rotate
περιφέρεια	district; precinct
περνάω	to pass; to spend
περνάω; περνώ	to pass
περνώ	to pass; to go through
περπατώ	to walk
πέρυσι	last year
πεσιμιστής	pessimist
πεταλούδα	butterfly
πετάω	to throw; to throw away; to fly
πετρόλ	petrol
πετώ	to fly
πέφτω	to fall
πέφτω έξω	to be wrong
πηγαίνω	to go
πηδάω; πηδώ	to jump
πιανίστας / πιανίστρια	pianist
πιάνω	to catch; to capture
πιάτο	plate
πιθανός	possible; probable
πίθηκος	ape / monkey
πίνω	to drink
πιπέρι	pepper
πιρούνι	fork
πιστεύω	to believe
πίστη	faith
πιστολάκι	hairdryer; blowdryer
πιστόλι	gun; handgun; pistol
πιστωτική κάρτα	credit card
πίσω	behind
πίτα	pie
πλατεία	square
πλατινέ	platinum white
πλάτος	width
πλατύς	wide; broad
Πλάτωνας	Plato
πλειοψηφία	majority
πλένω	to wash
πλεόνασμα	surplus
πλευρά	side
πληθυσμός	population
πληθωρισμός	inflation
πληρώνω	to pay
πλοίο	ship
ποδήλατο	bicycle
ποίηση	poetry
ποιμένας	shepherd
ποιο	what, which
ποιος	who
ποιότητα	quality
πολεμιστής	warrior
πόλεμο	war
πόλεμος	war
πόλη	city; town
πολίτης	citizen
πολιτιστικός	cultural
πολλαπλασιασμός	multiplication
πολύ	much
πολύγωνο	polygon
πολυθρόνα	armchair; lounge chair
πολύς	a lot; a lot of; very much
πολύχρωμος	multicolored
πονάει	to hurt
πονάω	to hurt
ποντίκι	mouse
ποντικί	mouse grey
ποπ κορν	popcorn
πόρτα	door
Πορτογαλία	Portugal
πορτοκαλάδα	orangeade
πορτοκάλι	orange
πορφυρός	royal purple
πόσες	how many
ποσό	amount; sum
πόσο	how much
Πόσο κάνει; / Πόσο κοσίζει;	How much does it cost?
ποσότητα	quantity
ποτέ	never/ever
πότε	when
ποτήρι	glass
πού	where
που, πως, ότι	that
πουθενά	nowhere
πουκάμισο	shirt
πουλάω	to sell
πουλί	bird
πουλώ	to sell
πράγμα	thing
πραγματικά	really
πραγματικός	real
πραγματικότητα	reality
πραγματοποιηθεί	be held
πράσινος	green
πρέπει	must
πρέπον	appropriate; proper; right
πριγκίπισσα	princess
πριν	ago; before
πρόβλημα	problem
πρόγονος	ancestor
πρόεδρος	president
προέλευση	origin
πρόθεση	preposition
προϊόν	product
προϊστάμενος	supervisor; manager; administrator
προκατάληψη	prejudice
πρόκειται	to be going to
προορισμός	destination
προς	towards
προσέχω	to look after; to take care of; to mind
πρόσθεση	addition
προσκαλέω	to invite
προσπαθώ	to try
προστάτης	protector
πρόσφατα	recently
πρόσφατος	recent
προσφέρω	to offer
προσφορά	offer
προσωπικό	staff
προσωπικός	personal
πρόσωπο	face
πρόταση	sentence
Προτεσταντισμός	Protestantism
προτιμώ	to prefer
προφανής	obvious
προφανώς	clearly
προφήτης	prophet
προχθές	the day before yesterday
προώθηση	promotion
πρωθυπουργός	prime minister
πρωί	morning
πρωινο	breakfast
πρωινό	breakfast
πρωτεύουσα	capital city; capital
πρώτο	first
πρώτος	first
Πρωτοχρονιά	January 1, New Year's Day
πυξίδα	compass
πυραμίδα	pyramid
πυρηνικός	nuclear
πυρίτιο	silicon
πυροσβέστη	firefighter
πώληση	sale
πωλητής / πωλήτρια	salesman / saleswoman
πώς	how
πώς είσαι;	How are you? (singular/informal)
πώς είστε;	How are you? (plural/formal)
πώς σε λένε;	What's your name?
ράφι	shelf
ρεαλιστής	realist
ρήμα	verb
ρόδα	wheel
ροδακινί	peach orange
ροδάκινο	peach
ροζ	pink
ρουμπίνι	ruby
ρούτερ	router
ρούχα	clothes
ρύζι	rice
Ρωσία	Russia
ρώσικος	Russian (origin)
ρωτάω	to ask
ρωτήσω	to ask
ρωτώ	to ask
Σ'αγαπώ / Σε αγαπώ	I love you
Σάββατο	Saturday
σαββατοκύριακο	weekend
σαν	as, like
Σαράντα	40
σε λίγο	in a bit
σε ποια	which
σέβομαι	to respect
σεντόνι	bedsheet; sheet
Σεπτέμβριος / Σεπτέμβρης	September
σηκώνω	to lift
σημαία	flag; banner
σημαντικό	important
σήμερα	today
σιγά	slowly, big deal
σιγά σιγά	very slowly
σίγουρα	certainly
σκεπή	roof
σκεπτικιστής	skeptic
σκέτος	black (coffee); plain
σκέφτομαι	to think of
σκηνή	scene
σκοπός	purpose
σκόρδο	garlic
σκοτώνω	to kill
σκουπίζω	to sweep, vacuum; to clean, wipe, polish
σκούρος	dark
σκουρόχρωμος	dark-colored
σκούφος	skull cap
σκύλος	dog
σμαράγδι	emerald
σμαραγδί	jade green
σοβαρός	serious
σοκολατί	chocolate brown
σομόν	salmon
σου	you
σούπα	soup
σουπερμάρκετ	supermarket
σοφίτα	attic; loft
σπαθί	sword
σπάνια	rarely
σταθμός	station
στάση	station
σταυρός	cross
σταφύλι	grape
σταχτί	(ash) grey
στεγνώνω	to dry
στείλω	to send
στέλνω	to send
στερεό	solid
Στην υγειά σου / Στην υγειά μας	Cheers
στιγμή	moment
στιχουργός	lyricist
στοιχειωμένος	haunted
στολή	uniform
στον δρόμο	on the way; on the street
στρατηγός	general
στρατιώτης / στρατιωτίνα	soldier
στρατιωτικός	military; military officer
στρατός	army
συγγενής	relative
συγγνώμη	sorry
συγγραφέας	writer
συγκεκριμένος	specific
συγνώμη	Sorry / Excuse me
σύζυγός	husband
σύζυγος	wife
συμβαίνω	to happen
συμβάνω	to go on; to happen; to occur
σύμβολο	symbol
συμπαθητικός	likeable; likable
συμπέρασμα	conclusion
συμπεριλαμβάνω	to include
συμφωνία	agreement
συναγωγή	synagogue
συναίσθημα	emotion
συναντάω	to meet
συνάντηση	meeting
συναντώ	to meet
σύνδεση	connected, login
σύνδεσμος	conjunction
συνέδριο	conference; convention; congress
συνέντευξη	interview
συνεχίζω	to continue; to go on; to keep on
συννεφιά	cloudy
συνταγή	recipe
συντάκτης	editor; writer; author
συντάκτης / συντάκτρια	editor
σύντομα	soon
Συρία	Syria
συρτάκι	syrtaki
συρτάρι	drawer
συσκευή	device; appliance
συσκευή πλοήγησης	navigation apparatus
συστήνω	to introduce; to suggest; to recommend
συχνά	often
σφουγγάρι	sponge
σχεδιάζω	to design
σχεδιαστής / σχεδιάστρια	designer
σχεδόν	almost
σχέση	relationship
σχετικά με	about
σχετικά μέ	about
σχετικός	about
σχετικότητα	relativity
σχήμα	shape
σχοινί	rope; tightrope
σχόλιο	comment
σώζω	to save
σωστός	correct
τα δεξιά	the right
τα εσώρουχα	the underwear
τα ζυμαρικά	the pasta
τα ισπανικά	Spanish (language)
τα κοσμήματα	the jewelry
τα λέμε	see you; see you soon; be talking to you
ταβάνι	ceiling
ταβέρνα	tavern; taverna
τάδε, δείνα	such and such; so-and-so
ταινία	movie
ταμίας	cashier
ταξί	taxi
ταξίδι	journey
ταχύς	swift, quick, fast, rapid
ταχύτητα	speed
τέλεια	great; excellent; perfect
τελειώνω	to finish; to end
τελευταία	lately
τελευταίος	last
τελικά	eventually
τελικά/τελικώς	finally, at last; eventually
τέλος	end; finale; ending
τενίστας / τενίστρια	tennis player
τεράστιος	huge; enormous
Τέσσερα	4
Τετάρτη	Wednesday
τέταρτος	fourth
τετράγωνο	square
τετράδιο	notebook; notepad
Τετρακόσια	400
τεχνική	technique
τεχνολογία	technology
τζαμί	mosque
τζιν	jeans
τηλεόραση	television
Τι κάνεις;	How are you?
Τι ώρα είναι;	What time is it?
τίγρης	tiger
τιμή	price
τίμιος	honest
τιμόνι	steering wheel
τιρκουάζ	turquoise
τμήμα	department; station; police station
τμήμα επειγόντων	emergency department
το αλάτι	the salt
το απόγευμα	the afternoon
το αριστερό	the left
το ασανσνέρ / ο ανελκυστήρας	the elevator / the lift
το αυγό	the egg
το αυτί	the ear
το αφεντικό	the boss
το βάζο	the vase
το βοδινό	the beef
το γλυκό του κουταλιού	the spoon sweet
το γράμμα	the letter
το γραφείο	the desk; the office
το δελφίνι	the dolphin
το δωμάτιο	the room
το δώρο	the gift
το έπιπλα	the furniture
το εστιατόριο	the restaurant
το καβούρι	the crab
το καθιστικό / το σαλόνι	the living room
το καλάθι	the basket
το καλοριφέρ	the radiator
το κάστρο	the castle
το κέικ	the cake
το κινητό	the mobile phone
το κλειδί	the key
το κλιματιστικό / το air conditioner	the air conditioner
το κοτόπουλο	the chicken
το κουτάλι	the spoon
το κουτί	the box
το κρεβάτι / το ντιβάνι	the bed
το κρύο	the cold
το λάδι	the oil
το λεμόνι	the lemon
το μαγαζί	the shop
το μαξιλάρι	the pillow
το μάτι	the eye
το μαχαίρι	the knife
το μπαλκόνι	the balcony
το μπάνιο / η τουαλέτα	the bathroom / the toilet
το μπαρ	the bar
το μπολ	the bowl
το μπουκάλι	the bottle
το μπουφάν	the jacket
το νησί	the island
το ντουλάπι	the cupboard
το ντους	the shower
το ξενοδοχείο	the hotel
το παιχνίδι	the toy; the game
το παράθυρο	the window
το πάρκο	the park
το πάτωμα	the floor
το περιοδικό	the magazine
το πιάτο	the plate
το πιρούνι	the fork
το πόδι	the leg
το ποντίκι	the mouse
το πορτοκάλι	the orange
το πρωί	the morning
το ραδιόφωνο	the radio
το ρετιρέ	the penthouse
το ρολόι	the clock
το σαπούνι	the soap
το σκόρδο	the garlic
το σουβλάκι / το καλαμάκι	suvlaki; grilled small pieces of meat, usually pork, but also chicken, served on the skewer for eating out of hand, or served as a sandwich wrapped in pita bread together with tomatoes, onions, tzatziki and ketchup
το σπίτι	the house
το στόμα	the mouth
το στυλό	the pen
το σφουγγάρι	the sponge
το τηγάνι	the pan
το τηλέφωνο	the telephone / the phone
το τράπεζα	the bank
το τραπέζι	the table
το ύψος	the height
το φως	the light
το χαλί	the rug; the carpet
το χαρτί	the paper
το χέρι	the arm
το χολ	the hall
το ψαλίδι	the pair of scissors
το ψυγείο	the refrigerator / the fridge
τοίχος	wall
τομάτα / ντομάτα	tomato
τόνος	ton; tonne
τόξο	bow
τοπικός	local
τοποθεσία	location
τόσο	this much/so much
τόσο ... όσο	as ... as
τοστ	toast
τότε	then
τουλάχιστον	at least
Τουρκία	Turkey
Τούρκικος	Turkish (origin)
τραγουδώ	to sing
τραίνο	train
τρακτέρ	tractor
τραμ	tram
τράπεζα	bank
τραπεζαρία	dining room; refractory
τραυματίζομαι	to be injured
τραυματίζω	to injure
τρεις	three
τρελός	crazy; insane; mad
τρέχω	to run
τρέχων	current; running
Τρία	3
Τριακόσια	300
Τριάντα	30
τριανταφυλλί	rose pink
τρίγωνο	triangle
τριπλός	triple
Τρίτη	Tuesday
τρίτος	third
τροφή	food
τσάι	tea
τσάντα	bag
τσέπη	pocket
τσιγάρο	cigarette
τύπισσα	gal; bod
τυρί	cheese
τυχαία/τυχαίως	randomly, by chance
τυχαίος	random
τώρα	now
υγρό	liquid
υδραυλικός	plumber
υλικό	material
υπάρχοντά	belongings
υπέροχος	wonderful; fantastic
υπεύθυνος	responsible; liable; in charge
υποβρύχιο	submarine
υπόγειο	basement
υπόγειος	basement
υπογράφω	to sign; to subscribe
υποστηρίζω	to support
υποστήριζω	to support
υποσυνείδητο	subconscious
υπόσχομαι	to promise
υψηλός, ψηλός	high
φαγητό	food
φαίνω	to appear
φάλαινα	whale
φανάρι	traffic light
φανέλα	jersey
φαντάζομαι	to imagine
φάντασμα	ghost
φαρδύς	wide; loose
φάρμακο	medicine
Φεβρουάριος / Φλεβάρης	February
φέρνω	to bring
φέρω	to carry, bring
φεστιβάλ	festival
φέτα	feta cheese
φέτος	this year
φεύγω	to leave
φθηνότερο	cheapest
φθινόπωρο	autumn
Φθινόπωρο	autumn
φίδι	snake; serpent
φίλη	friend/girlfriend
φιλί	kiss
φιλικός	friendly
φίλος	friend/boyfriend
φιλοσοφία	philosophy
φιλόσοφος	philosopher
φοβάμαι	to be afraid
φοιτητής / φοιτήτρια	student (university)
φορά	time
φόρεμα	dress
φορτηγό	truck
φορώ	to wear
φουξ / φούξια	fuschia
φούρνο	oven; bakery
φούστα	skirt
φράουλα	strawberry
φρέσκο	fresh
φρέσκος	fresh
φρούριο	fortress
φρουρός	guard
φρούτο	fruit
φτηνός	cheap
φτιάχνω	to make
φύλακας	guard
φυσικός	natural
φυσιολογικός	normal
φυστικί	pistachio green
φως	light
φωτιστικό	lamp; light fixture; light
χακί	khaki
χάλκινο	copper
χάμστερ	hamster
χάνω	to lose; to miss
χαρακτήρος	character
χάρηκα	Nice to meet you; pleased; I am happy
χείλη	lips
χειμώνας	winter
Χειμώνας	winter
χελώνα	turtle
χέρι	hand
Χημεία	chemistry
χθες	yesterday
Χίλια	1000
χιλιάδα	thousand
χιλιετία	millennium
χιλόμετρο	kilometer / kilometre
χιονίζει	it snows
χοιρινό	pork
χολ	hall
χοντρός	fat
χορός	dance
χορτοφάγος	vegetarian
χρoνών	years of age; years old
χρειάζομαι	to need
χρέος	debt
χρήμα	money
χρήματα	money
χρηματιστήριο	stock exchange
χρησιμοποιώ	to use
χρήστης	user
χριστιανή	Christian
Χριστούγεννα	December 25, Christmas Day
Χρόνια πολλά	Many happy returns of the day
χρόνος	year
χτενίζω	to comb
χτυπάω	to hit; to beat; to get hurt
χυμός	juice
χώρα	country
χώρια/χωριστά	separately
χωριό	village
χωρίς	without
ψαλίδι	scissors
ψάρι	fish
ψάχνω	to search/look for
ψηλός	tall
ψυγείο	fridge
ψυχή	soul
ψυχοθεραπευτής / ψυχοθεραπεύτρια	psychotherapist
ψυχολογία	psychology
ψωμί	bread
ωκεανός	ocean
ώρα	hour; o'clock; the time
ωραίος	nice; beautiful
ως	as a; as; to
ωστόσο	yet; nonetheless; nevertheless
