अकड़	arrogance
अकड़	become stiff
अकड़	behave defiantly
अकादमी	academy
अकेला	alone
अकेलापन	aloneness
अकेली	alone
अकेली	Alone
अक्‍कड़-बक्‍कड़	A game
अक्खड़	arrogant
अक्‍खड़	arrogant
अखाड़ा	Camp
अंग	body part
अंग-प्रत्‍यंग	body part
अगड़-बगड़	balderdash
अंगरक्षक	Body Gourd
अगल-बगल	adjoining
अगला	ahead of
अंगारा	burning charcoal
अंगीठी	brazier
अग्‍नि-कण	a spark [of fire]
अग्‍निकण	burning
अग्रगामी	anterior
अग्रिम	advance
अघा	be satisfied
अघोरी	a sect who believes in extravagant eating and drinking
अघ्येय	behind comprehension
अचलगढ	achal garh
अच्छा	better
अजमेर	Ajmer; Name of a city
अजवायन	aromatic seed
अटक	be embroiled
अटपटा	absurd
अटलांटिक	atlantic
अंटसंट	absurd
अटारी	attic
अंटार्कटिका	Antarctica
अटेरन	Bobbin
अंतरिक्षयात्री	astronaut
अतल	abyssal
अति-प्रिय	beloved
अतिरिक्‍त	additional
अतिरिक्त	additional
अतिरिक्त‍त	additional
अंत्‍याक्षरी	antyakshare
अत्याचार	atrocity
अथर्ववेद	atharvaveda
अंदेशा	apprehension
अद्भुत	amazing
अद्‌भुत	amazing
अद्‍भुत	amazing
अद्‍भुत	Amazing
अधखुला	ajar
अंधा	blind
अंधानुकरण	blind belief
अंधापन	blindness
अधिकार-पत्र	authorisation
अधिवृक्की	adrenal
अंधी	blind (female)
अनसु	avoid
अनाजघर	barn
अनासागर	ana sagar
अनिश्‍वरवादी	agnostic
अनुकूल	agreeable
अनुचर	acolyte
अनुचित	be unfair
अनुपस्थित	absent
अनुपस्‍थित	absent
अनुपस्थिति	Absence
अनुरक्‍त	attached
अनुरागी	amature
अनुसार	acccording to
अनुसार	according to
अनुसार	accordingly
अनुस्‍वार	anasal character of Nagari alphabet
अन्‍तवस्‍त्र	bodice
अन्‍दाज	assessment
अन्धा	blind
अन्‍धा	blind [m]
अन्‍धी	blind [f]
अन्न-पूर्णा	Anna-Purna
अन्‍य	another
अपनत्‍व	affinity
अपना	adopt
अपनापन	Affinity; feel friendly toward
अपने-अपने	by oneself
अपमान	ashamed
अपराधी	accused
अपशकुन	bad omen
अपशकून	bad omen
अपशब्‍द	abuse
अपशब्द‍	abuse
अपशब्द	Abuse
अपील	appeal
अपेन्डिक्स	appendix
अप्रैल	April; april
अफगानिस्तान	Afganistan
अफ्रिका	Africa
अब्राम	Abram
अभिकरण	agency
अभिनय	acting
अभिनेता	actor
अभिमान	arrogance
अभिमान	Attitude
अभिमानी	arrogant
अभियान	campaign
अभियुक्त	accused
अभियोग	accusation
अभिलाषी	ambitious
अभीमनी	Arrogant
अभ्यस्त	accustomed
अभ्‍यस्‍त	accustomed; habitual
अमरकोट	Amarkot
अमरासर	Amarasar (village)
अमरिकन	american
अमरीका	America
अमरीन	Amrin
अमलतास	Amalatas
अयेने	Athens
अयोध्या	Ayodhaya
अयोध्‍या	Ayodhya
अयोध्‍या	Ayodhya (a name of city)
अरणियां	Araniya
अरणी-वन	Arni - Forest (a name of forest)
अरथी	bier
अरब	billion; billion
अरबपति	billiionaire
अरबों	billions
अराजकता	anarchy
अराजकता	Anarchy
अरे!	Are
अरे!	Are!
अर्गला	a log for fastening a door
अर्गला	bolt
अर्थी	[funeral] bier
अर्थी	bier
अर्द्धवार्षिक	Biannual
अलग	apart
अलमारी	almari
अलवर	Alwar
अलावा	besides
अलिंद	atrium
अलैंगिक	asexual
अल्‍लाउद्दीन	Allauddin
अल्लाह	allah
अल्‍लाह	Allah
अवनति	Anticlimax
अवरुद्ध	blocked
अवरोध	barricade
अविवाहित	bachelor
अशांत	Bothersome
असममित	asymmetrical
असामाजिक	antisocial
असामान्यता	abnormality
असालिया	a plant
असावधान	careless
अस्‍तु	amen
अस्त्र-शस्त्र	Armor
अस्‍त्र-शस्‍त्र	arms and ammunition
अस्थमा	asthma
अस्‍सी	80
अहरन	anvil
अहा!	Aha
आंक	assess
आंक	assess
आक	Awk
आकर्षण	attractive
आकस्मिक	accidental
आकांशा	ambition
आक्रमण	attack
आक्रामक	aggressive
आक्षेप	allegation
आखातीज	Akhateej
आखिर	After
आगमन	arrival
आगरा	Agra
आगार	Agra
आगे	ahead
आगे	ahead of
आगे	before
आघात	blow
आड़	barrier
आंतक	awe
आततायी	Bad man
आतुरता	anxiety
आंतें	bowel
आंतें	Bowel
आदी	accustomed to
आंदोलन	agitation; movement
आधार	base
आधार	basic
आधार-शैल	bedrock
आफत	calamity
आबू	Abu
आभा	beauty
आयु	age
आयुर्वेदिक	Ayurvedic
आयुर्वैदिक	Ayurvedic
आर-पार	across
आरंभ	beginning
आरम्‍भ	beginning
आरोप	blame; charge
आर्य	Arya
आर्य	Aryan
आर्यजन	araya men
आर्शीवाद	bless
आवश्‍यकतानुसार	according to need
आवश्‍यकतानुसार	as required
आवश्यकतानुसार	As required
आवाज	a sound
आवाज	call
आवास	accommodation
आशंका	apprehension
आशय	aim
आशिष	blessing
आशीर्वाद	blessing
आशीष	blessings
आश्‍चर्यचकित	astonished
आश्चर्यजनक	Amazing
आश्‍चर्यजनक	astonishing
आश्‍वासन	assurance
आस-पास	around
आसक्ति	attachment
आसगंद	Asgand
आसपास	around here; near about
आसमानी	blue
आस्था	belief
इकन्‍नी	anna
इकहरा	alone
इच्‍छानुसार	according to one's desire
इतरा	act affectedly
इंद्रायण-लता	Bitter - Lata
इधर-उधर	around
इनको	[to] them
इनमें	[in] these
इने-गिने	a few
इन्‍तजाम	arrangement
इर्द-गिर्द	all round
इलायची	cardamom
इल्‍लत	botheration
इस्त्री	a smoothing iron
ईंट	brick
उकता	be bored
उकसा	Actuate; to instigate
उक्‍त	above
उखड़	be uprooted
उखड़	be uprooted; come out
उछाल	boom
उजड़	be ruined
उज्जवल	bright
उज्‍जवल	bright
उज्जवल	Bright
उठाव	abolition
उडनखटोला	a legendary flying palanquin
उड़ा	blow
उतर	alight
उतावला	bad-tempered
उत्कंठा	anxiety
उत्तम	best
उत्तर	answer
उत्‍पन्न	born
उत्‍सर्ग	abandonment
उत्सुकता	anxiousness
उत्सुकता	Avidity
उदरपीड़ा	apendix
उदार	benefactor
उद्दंडता	arrogance
उद्दण्‍ड	arrogant
उद्दण्‍डता	arrogance
उद्दण्‍डता	arrogancy
उद्दण्डता	Boastful
उद्देश्‍य	aim
उन	3.sg.dist.f
उन्मूलन	abolition
उपकार	benefaction
उपकार	beneficence
उपयुक्‍त	befitting
उपरांत	after
उपलब्‍ध	available
उपलब्धता	available
उफन	boil over
उबटन	a paste for smearing the body
उबल	boil
उबाल	boil
उमंग	ambition
उमराव	aristocrat
उम्र	age
उलझ	be entangled
उलझन	botheration
उसको	[to] him
उससे	by
उस्‍ताद	boss
ऊँट	camel
ऊंट	camel
ऊँट-सवार	camel rider
ऊँटगाड़ी	camelcart
ऊँटनी	camel (female)
ऊपर	above
ऊपर	at
ऊपरी	above
ऊब	be bored
ऊब	Bored
एकदम	at once
एकलप	abandoned
एंड्रयू	Andrew
एलान	announcement
एस.टी.सी.	Acronym for Secondary Teaching Certificate
ऐंठ	be pulled tight
ऐसे	as
ऑस्ट्रेलिया	Australia
ओट	blindage
ओठी	camel [who graze the camels]
ओढनी	a woman's mantle
ओर	at
औटा	boil
और	and
और	any more
कई	a few
कंकण	bracelet
कंगन	bangle
कंगन	bracelet
कंगाल	Bankrupt
कंचुकी	bodice
कच्छा	Briefs
कट	be cut
कटु	bitter
कटुभाषी	bitter speaker
कटोरा	bowl
कटोरी	bowl
कड़वा	bitter
कड़वा	Bitter
कड़ा	bangle
कड़ुवा	bitter
कढ़ी	a curry prepared from whey and gram flor
कनस्‍तर	canister
कन्यादान	bestowing
कपट	cabal
कपाट	a door panel
कपूत	bad son
कपूर	camphor
कप्‍तान	captain
कफरनहूम	Capernum
कब्‍जा	capture
कमजोर	Boneless
कमरपट्टा	belt
कमरबंद	belt
कम्‍बल	blanket
कम्बल	blanket
कम्‍बल	blankit
करतूतां	acts
करबा	a dish made of curd and rice
करार	agreement
करील	a thorny plant
कर्ण-सबंधी	aural
कर्म	act
कलंक	blemish
कलंक	blot
कलंकित	blemished
कला	art
कलाकार	actor
कलाकार	artist
कली	bud
कल्‍प	assume
कवच	armor
कष्‍ट	ache
कष्‍ट	calamity
कसमसा	be in tension
कसरत	an exercise
कसाई	butcher
कसैला	acidness
कह	affirm
कहर	calamity
का	[gen]
काकी	aunt in law
काख	armpit
कांख	armpit
काजल-बिन्दी	Care for a baby
काट	bite
काट	breach
कांटेदार	barbed
काथा	acacia
काँप	be alarmed
कांप	bicker
काफी	ample
कामवास	be attractive to sex
कामोत्तेजक	aphrodisiac
कायफल	Box myrtle
कार	car
कारवाँ	caravan
कारीगर	artisan
कार्ड	card
कार्य	act
कार्यवाही	action
काला	black
कालिख	blackness
कालिमा	blankness
कालीन	carpet
कालीमिर्च	black pepper
कांस्‍य	bronze
किंचित	a little
किताब	book
किनार	border [of cloth]
किनारा	bank
किनारा	border
किरण	Beam
किरन	beam
किश्ती	boat
किसी	any
कीटाणु	bacteria
कीर्ति	Brightness
कुचल	break down
कुछ	A few
कुछ	aught
कुतिया	Bitch
कुत्ती	bitch
कुध्द	angry
कुप्रथा	bad custom
कुबुध्‍दि	bad wisdom
कुबुध्‍दि	bad wisdom person
कुरज	a birds
कुरीतियां	bad custom
कुरीती	bad custom
कुर्की	attachment
कुल	aggregate
कुल	all
कुलबुला	be restless
कुलीन	a well born
कुल्‍हाड़ी	axe
कुल्हाड़ी	axe; axe
कुल्‍हाड़ी	battle-axe
कुँवारा	bachelor
कुंवारा	bechler
कुश	a kind of grass
कुसमय	bad time
कुसमय	Bad times
कूंडा	a large earthern vessel
कूल्‍हा	buttock
कृत्रिमता	affectation
कृत्रिमता	artificiality
कृषि	Agriculture
कृषि-कर	agricultural rent
कृषि-कार्य	agriculture work
कृषि-भूमि	agricultural land
केला	banana
केले	Bananas
कोई	any
कोई-कोई	a few
कोण	Angle
कोप	anger
कोंपल	bud
कोरा	blank
कोलाहल	Babel
कोशिश	attempt
कोसली	blouse
कौर	a mouthful
कौर	bit
क्यारी	bed
क्योंकि	As or Because
क्‍योंकि	because
क्रमानुसार	by turn
क्रुद्ध	Angry
क्रोध	anger
क्रोध	Angry
क्रोधन	anger
क्रोधित	angry
क्रोधी	angry
क्‍लेश	affliction
क्षमता	ability
क्षमता	capacity
क्षमता	Capacity
क्षार	alkali
क्षेत्र	area
क्षेत्रफल	area
क्षेत्रफल	Area
क्षैत्र	area
ख	affliction
खटिया	Bed
खट्टा	acetic
खंड	block; Block
खंडित	broken
खण्‍ड	block
खण्‍डित	broken
खण्‍िडत	broken
खरताळ	An musical instrument
खरल	a mortar
खरापन	candidness
खरापन	Candor
खराब	bad
ख़राब	bad
खरीद	buy
खरीददार	buyer
खरीदार	buyer
खरोंच	bruise
खरोंच	bruise
खलबली	anarchy
खलिहान	Barn
खाड़ी	bay
खाता	account
खाता	account book
खाली	blank
खिंचाव	attraction
खिल	bloomed
खिलाफ	against
खीज	annoyance
खीज	be irritated
खुरपा	a grubbing or scraping instrument
खुरपा	a scraping instrument
खुल	be untied
खुशामद	adulation
खून	blood
खूबसुरत	beautiful
खूबसूरत	beautiful
खूबसूरत	Beautiful
खेमा	camp
खैर	all right
गंज	baldness
गंजा	bald
गंजा	bald headed
गंजापन	baldness
गठजोड़	Alliances
गठजोड़ा	alliance
गठरी	bundle
गड़	be pitched
गड़बड़ी	bungling
गड्डी	bundle
गड्डें	a game played by girls and women with small stone balls
गणना	calculation
गत्ता	board
गत्ता	card board
गद्दा	camel carpet
गधा	ass
गप्‍प	bragging
गरज	adulation
गरमी	Caloric
गरीबी	adversity
गरुड़	bird of jove
गली	Alleyway
गलीचा	carpet
गंवार	bestial
गाड़	bury
गालियां	abuse
गाली	a term of abuse
गाली	abuse
गिनती	calculation
गुच्‍छा	bunch
गुच्छा	Bunch
गुजर	bear
गुंजाइश	capacity
गुट	batch
गुण	attribute
गुणहीन	bad
गुदा	anus
गुब्‍बारा	baloon
गुमनाम	anonymous
गुमाश्‍ता	accountants
गुलदस्ता	bouquet
गुलदस्‍ता	Bouquet
गुल्ली	bail
गुस्‍सा	anger
गुस्‍सा	angry
गुस्सा	angry
गुस्सा	Angry
गुस्‍सैल	Angry
गुहार	appeal
गूदड़ी	bedding of rags
गेंद	ball
गेंद	Ball
गैर	alien
गैरहाजरी	absence
गोट	border
गोना	bring to lady after the marriage
गोभी	cabbage
गोलमाल	bungling
गोला	bomb shell
गोला	cannon ball
गोली	ball
गोली	bullet; bullet
गौरव	Boast
ग्वारपाठा	Aloe vera
घंटा	bell
घंटी	bell
घबरा	be confused
घबरा	be frightened
घबरा	be perplexed
घबरा	bewildered
घबराहट	Anxiety
घबराहट	bewilderment
घमण्‍ड	attitude
घमण्डी	Arrogant
घमण्‍ड़ी	big headed
घर	abode
घरघराहट	a whizz
घाघरा	a long loose skirt or pettcoat worn by women in India
घिसट	be dragged
घुगरा	a special nupoor ornament using especially dance on the holi festival
घुंघची	a shrub abru precatorius or its seed
घुंघरु	ankle-bell
घुंघुरु	ankle-bells
घूंट	a sip
घृतकुमारी	Aloe vera
घोषणा	announcement
घोषणा	Announcement
चकत्ता	a blot on the skin
चकला	Bawdy house
चकित	amazed
चकित	Baffled
चंचलता	agility
चड़स	a leather bucket
चढ़ाई	ascent
चपाती	bread of grain or corn flour
चमक	Brighten
चमकीला	bright
चमगादड़	bat
चमाचम	bright
चलनी	a sieve
चाची	aunt
चापलूसी	Applesauce
चारण	Bard
चारदिवारी	boundary wall
चारदीवारी	boundary wall
चारपाई	Bunk
चारों	all the four
चालाकी	alacrity
चालाकी	artifice
चिड़िया	bird
चिढ़	be irritated
चिढ़	be teased
चिढ़ा	annoy
चिंता	anxiety
चिंतामुक्‍त	carefree
चिंतित	anxious
चित्रकार	artist
चिनगारी	arc
चिन्‍ता	anxiety
चिपक	adhere
चिपक	be affixed
चींटी	ant
चुखलखोर	back-biter
चुगलखोर	backbiter
चुगलखोर	backbitter
चुगली	back-biting
चुगली	calumny
चुग्गा	birdseed
चुड़िया	bangles
चुपड़	anoint
चूड़ा	a kind of armlet or bracelet made of ivory
चूड़ी	bangle
चूड़ी-सेट	bangle-set
चूड़ीगर	bangle-man
चूड़ीयां	Bangles
चूस	absorb
चेतावनी	Alert
चोंच	beak
चोट	blow
चोला	a loose garment
चोली	blouse
चोली	bodice
चोली	bra
चौंक	be alarmed
चौंक	Be amazed
चौंक	be startled
चौंक	be surprised
चौकी	a low square seat
चौकी	a low stool
चौड़ा	broad
चौड़ाई	breadth
चौड़ाई	breadth or width
छज्‍जा	balcony
छज्जा	Balcony
छज्‍जा	balcony; eaves
छड़ी	cane
छत्री	canopy
छर्रा	buck shot
छलांग	across
छाछ	butter milk
छाती	bosom
छावनी	cantonment
छिल	be husked; to be scratched
छींटा	blot
छुटकारा	acquittal
छेद	bore
छैनी	An equipment used for shaping stone.
छोटी	a squad [of troops]
छोड़	abondon
छौंक	act of seasoning spices with which food is seasoned
छौंक	browning spices in heated oil or ghee
जगा	awaken
जँच	appeal
जँच	be teated
जन्‍म	birth
जन्म	Birth
जन्म	born
जन्म	brith
जन्‍म-घुट्टी	a digestive mixture [for infants]
जन्‍मजात	By birth
जन्‍मपत्री	a small horoscope
जन्‍मा	born
जन्‍माष्‍टमी	Birthday of Lord Krishna
जम	be fixed up
जमालगोटा	a game and a durg
जमाव	accumulation
जरा-सी	a little
जल	burn
जल	burn; burn
जलन	burn
जलन	burning
जलन	burning sensation
जला	burn
जवाब	answer
जागृत	a woke
जागृत	aware
जाग्रत	awakening
जाजम	carpet
जानवर	animal
जानवर	Animal
जानवर	ANIMAL
जामुन	black plum
जासूस	agent
जितना	as mcuh as
जितना	as much as
जिंदा	alive
जिससे	by which
जीवयोनि	birth cycle
जीवित	alive
जीवित	allive
जुड़	be added
जुड़ा	Attached
जुड़ाव	bonding
जुत	be ploughed
जुत	be tilled
जुत	be yoked
जुल्‍म	atrocity
जूते	boot; shoes
जेलखाना	calaboose
जैसा	alike
जैसा	as
जैसी	as
जैसे	as
जैसे	as if
जोगी	ascetic
जोड़	add
जोड़	addition
जोशपूर्ण	Animated
जौ	barley
जौहर	alive jump in fire (at battle)
ज्‍यों	as
ज्‍यों-ज्‍यों	as
ज्‍योतिष	astrologist
ज्योतिषी	Astrologer
ज्‍योतिषी	astrologer; diviner
ज्वाला	blaze
ज्‍वाला	blaze
झगड़ालू	bad character
झंझट	annoying situation
झंझट	botheration
झट	atonce
झटका	Blow
झटपट	at once
झमेला	botheration
झलकना	blob
झाङू	broom
झाड़ियाँ	bushes
झाड़ी	bush
झाड़ी-समूह	bush-grove
झाड़ीदार	bushy
झाडू	broom
झाड़ू	broom
झांसा	betryal
झांसा	bluff
झिड़की	admonition
झुक	bend
झुक	bow
झुक-झुककर	by bowing
झुंझलाहट	annoyance
झुलस	be scorched
झूठमूठ	affectedly
झोंपड़ी	a small hut
झोलो	bag
टंकोरा	bell
टक्‍कर	bump
टक्कर	bump
टखना	ankle
टखना	ankle; ankle
टंग	be hang
टल	be averted
टल	be displaced
टहनी	branch
टिकिया	cake
टिगारी	an iron hollow utensil
टिंडी	a vegetable
टीका	a sectarial mark on the forehead
टुट	break up
टूट	be broken
टूट	break
टेढ़ा	awry
टेढ़ा	Bend
टेढ़ापन	Arcuation
टेढ़ापन	bend
टेढ़ी	awry
टोकरी	basket
टोपी	cap
ठठेरा	brazier
ठिकाना	address
ठीक	appropriate
डंका	A wooden stick to play a drum
डंडा	Bar
डंडा	baton
डमरू	a musical instrument
डर	be afraid
डर	be frightened
डलिया	basket
डस	bite
डायन	a female imp
डिब्‍बा	box
ढंग	attitude
ढल	be moulded
ढाल	be moulded
ढोकला	an eatable dish
तख्‍ता	board
तट	bank
ततैया	bee (honey)
तत्‍काल	at once
तत्पर	beat upon
तन्‍मयता	absorption
तपस्वी	ascetic; ascetic
तबला	A musical instrument
तंबूरा	A type of musical instrument
तम्‍बू	bamber
तरफ	at
तरफ़दारी	backing
तराजू	balance
तर्क	argument
तल	base
तल	bottom
तलवार	brand
तलहटी	Bottom
तसमा	belt
तहखाना	basement
तांई	aunt
ताक	ambush
ताबीज	amulet
ताबीज़	Amulets
तारा	a planet
तारा	a star
तालीयांड	Applause, claping
तितली	butterfly
तिथि	a lunnar day
तिलक	an auspicious mark [on forehead]
तिलक	auspicious mark [on forehead]
तिलपट्टी	a kind of sweet meat composed of pounded sesamum and Gur or sugar
तीक्ष्‍ण	Acute
तीक्ष्‌णता	Acuity
तीर	arrow
तीर-कमान	Bow-arrow
तीरंदाजी	archery
तीव्र	acute
तुच्छ	banal
तुरन्‍त	at once
तुरन्त‍	at once
तुर्रा	a kind of tassel worn in the turban
तुलसी	basil
तूलिका	brush
तेज	brisk
तेजाब	acid
तो	besides
तोड़	break
तोड़ा-फोड़ी	Broke - bust
तोंद	belly
तोप	Cannon
तोपची	Cannoneer
था	[this is past action verb] Was
थाह	bottom
थी	[this is past action verd] Was
थैला	a large bag
थैला	a sack
थैला	bag
थोक	Bulk
थोड़ा	a few
थोड़ा-सा	a little
थोड़ी	a few
दंत-समूह	a set of teeth
दत्तक	Adoptive
दफना	bury
दब	be pressed
दब	be pressed down
दबा	apply pressure
दरार	breach
दर्शन	apprearance
दलाल	agent
दलाल	broker
दलाली	brokerage
दंशन	bitting
दस्‍तरी	card sheet
दस्ता	butt
दाग	brand
दाढ़ी	beard
दाढ़ी	Beard
दांतुन	brush
दाना	bread
दानापानी	bread and butter
दांव	a bet
दांव	a stake
दावत	banquet
दास	captive
दाह	burning heat
दिक्‍कत	botheration
दिखाव	appearance
दिमाग	brain
दिवाला	bankruptcy
दिवालिया	bankrupt
दुख	ache
दुख	calamity
दुखी	afflicated
दुबारा	again
दुर्गंध	bad smell
दुर्घटना	accident
दुर्दशाग्रस्‍त	afflicted
दुलार	caress
दुल्‍हन	bride
दुल्‍हन	bridegroom
दुश्मनी	animosity
दुश्‍मनी	Animosity
दुष्‍टता	badness
दूत	ambassador
दूती	bawd
दूब	a kind of green grass
दूर	away
दूरबीन	binoculars
दूल्हा	bride
दूल्‍हा	bridegroom
दूल्हा	Bridegroom
दृश्‍य	appear
देख-रेख	care
देखभाल	care
देखरेख	care
देवासी	A cast
देह	body
दैवयोग	accidental happening
दो	both
दोनों	both
दोष	blame
दोषारोपण	accusation
दोहपर	afternoon
द्रढ़-विश्‍वास	assertion
द्रष्‍टिदोष	bad vision
द्वारा	by
द्विअर्थी	[of] double meaning
धड़क	be thrilled
धधक	burn fiercely
धंधा	business
धन	amount
धनमाल	capital
धनुष	bow
धब्‍बा	blot
धमाका	bang
धमाचौकड़ी	bustle
धाक	awe
धावा	assault
धावा	attack
धिक्‍कार	abuse
धुनकी	carding instrument
धुरा	axis
धुरी	axle
धूर्त	Artful
धृष्‍टता	Audacity
धौंकनी	bellows
धौंस	browbeating
ध्‍यान	attention
ध्यान	attention
ध्‍यानपूर्वक	attentively
नक्षत्र	a lunar asteroid
नखरा	Attitude
नफरत	antipathy
नमन	bending
नमाज	a formal prayer [offered by Muslims]
नरभक्षक	cannibal
नर्तक	actor
नली	barrel
नवरात्रि	a festival
नसीहत	advice
नस्‍ल	breed
नहर	canal
नहलाना	bathe
नहा	bath
नहाना-धोना	bathing and washing
नहीं	a word denoting negation
नाई	Barbar
नाई	barber
नांई	Barber
नाभि	bellybutton
नामपता	address
नाराज	angered
नाराज	angry
नाराज	annoyed
नाराज़	Annoyed
नाव	boat
नाश	annihilation
नाश्‍ता	breakfast
नास्‍तिक	atheist
निखर	become clear
निडर	berserk
निडर	bold
निडर	brave
नितम्ब	buttock
निथर	be decanted
निथर	become clear
निपट	be disposed of
निपट	be finished
निपट	be relieved
निपट	be settled
निपुण	Accomplished
निबन्‍ध	an article
निभा	adjust
नियुक्‍त	appointed
नियुक्‍त	appointed; to get appointed
नियुक्ति	appointment
निरन्‍तर	always
निरस्‍त	cancel
निरस्‍त	cancelled
निराई	act of weeding
निराधार	baseless
निरुद्देश्‍य	aimlessly; without reason
निर्दोष	blameless
निर्धन	beggarly
निर्धनता	beggary
निर्भय	boldly
निवास-स्‍थान	abode
निवेदक	applicant
निश्‍चय	assuredness
निश्‍चित	ascertained
निश्‍चिंत	assured
निश्‍चिंत	carefree
निश्‍चिंतता	carefulness
निषिद्ध	banned
निहाई	anvil
निहाई	Anvil
नीचता	abjection
नींबूपानी	a drink made of water, salt, sugar and lemon juice
नीला	blue
नीलाम	auction
नींव	base; base
नेग	a propitiatory offering
नेत्रहीन	blind
न्‍यौछावर	bestow
पक	be cooked
पक	boil
पकोड़ा	a saltish preparation of Urd pulse
पंक्तिबध्‍द	arranged in a line or row
पंक्तिबध्‍द	arranged in a row or line
पक्षपात	bias
पक्षी	bird
पच	be digested
पंचांग	almanac
पंचांग	calendar
पछता	bemoan; to repent
पटना	being on good terms
पट्टा	belt
पट्टियों	a strong cloth of camel seat
पट्टी	bandage
पड़ाव	camp
पणगट	a common water tank in village
पण्‍डित	a title of respect for learned person
पता	address
पता-ठिकाना	Address - Location
पत्ता	card
पर	at
परन्‍तु	but
परब्रह्म	Brahma
परवाह	care
परहेज	abstain
परहेज	abstinence
परहेज	astinence
परहेज	avoidance
परहेज	avoiding
पराया	alien
परायापन	alienity
परिचय	acquaintance
परिचित	acquainted
परित्‍याग	abandonment
परिवर्तन	alteration
परेशान	bothered
परोपकार	benevolence
पलंग	bad
पलंग	bed stead
पलड़ा	balance
पलड़ा	balance-pan
पलीता	burning firewood
पवन	air
पशु	animal
पशु	Animal
पशु-वैग्यानिक	Animal scientist
पश्‍चात	afterwards
पश्‍चात्	after
पहचान	acquaintance
पहल	beginning
पहलू	aspect
पहले	before
पहुंच	access
पहुंच	access [to]
पहुंच	approach
पहुँच	arrival
पहुंच	arrive
पागलखाना	bedlam
पाजेब	anklet
पाठान्‍तर	a variation in the text of a book or manuscripit
पान	betel-leaf
पायल	anklet
पास	boundary
पिचपिचा	adhesive
पिछला	back
पिंजरा	cage
पिट	be beaten
पिंडली	calf of the leg
पिण्‍डली	calf
पिन	a pin using in Sari etc.
पिलांण	camel seat
पिस	be grounded
पीछे	after
पीछे	Back
पीछे	behind
पींज	card
पीट	beat
पीट	bit
पीठ	back
पीहू-पीहू	a sound
पुकार	call
पुकार	call
पुचकार	caress
पुण्‍य-तिथि	anniversary of death
पुन	again
पुनः	again
पुन	anew
पुरस्‍कार	award
पुल	bride; bridge
पुल	bridge
पुलिंदा	bundle
पुश्‍तेनी	Ancestral
पुस्‍तक	book
पूंजी	capital
पूर्णरुपेण	Altogether
पूर्वज	ancestor
पूर्वज	ancestor (f)
पूर्वज	ancestor (m)
पृष्ठभूमि	background
पेट	belly
पेंदा	base; surface
पेंदा	bottom
पेर	be crushed
पैंदा	bottom
पैंदा	bottom; bottom
पैंदी	bottom
पैंदी	Bottom
प्‍यार	affection
प्‍यारा	affectionate
प्‍यारा	beloved
प्‍यारी	beloved
प्‍याला	bowl
प्रचुर	abundant
प्रचुरता	abundance
प्रज्‍जवलित	blazing
प्रणाम	bow
प्रतिदिन	always
प्रतिनिधि	agent
प्रतिबंध	ban
प्रतिभाशाली	brilliant
प्रतियोगिता	A competetion
प्रत्‍यक्ष	apparent
प्रदेश	area
प्रधान	basic
प्रधान	captain
प्रबंध	arrangement
प्रबन्‍ध	arrangement
प्रबोधन	admonition
प्रभावी	applied
प्रयत्‍न	attempt
प्रयाग	A religious palace
प्रयास	attempt
प्रवेश	admission
प्रसारित	broadcast
प्रहर	a period of three hours
प्रहार	assault
प्रहार	bash
प्रहार	blow
प्राचीन	ancient
प्राचीन	ancient; ancient
प्रामणिकता	Authenticity check
प्रामाणिक	authentic
प्राय	Almost
प्रायश्‍चित	atonement
प्रारंभ	beginning
प्रारम्‍भ	beginning
प्रार्थना-पत्र	application
प्रार्थना-पत्र	appplication
प्रिय	beloved one
प्रीति	affection
प्रीतिभोज	banquet
प्रेतबाधा	calamity
प्रेम	amour
प्रेमिका	beloved woman
प्रौढ़	adult
प्रौढ़	Adult
फट	be torn
फट	burst
फटाफट	at once
फफोला	blister
फरसा	Ax
फरार	absconding; absconding
फल	bear fruit
फली	bean
फंस	be ensnared
फंस	be entangled
फंस	be entraped
फँस	be entrapped
फँस	be involved
फाहा	a flake of cotton
फिटकरी	alum
फिर	again
फिसाद	altercation
फ़ीता	bootlace
फुंकणी	blowpipe
फुन्‍सी	boil
फुर्तीला	brisk
फुसला	allure
फुसला	cajole
फुंसी	boil
फूंक	blowing; to blow
फूंकनी	blow pipe
फूंकनी	blower
फैल	be spread out
फैल	be stirred up
फैल	become public
फोड़ा	abscess
फोड़ा	blister
फोड़ा	boil
बंकनाल	a blower
बखारी	barn
बग	bug
बगल	arm-pit
बंगला	bungalow
बघार	brag
बच	be saved
बच्‍चा	baby
बच्‍ची	baby [f]
बछड़ा	calf
बज	bang
बजट	budget
बंट	be distributed
बटन	ball-shaped button
बटन	button
बटन	Button
बड़बोला	bigmouthed
बड़बोला	braggart
बड़बोली	bigmouthed lady
बड़ा	big
बड़ीयाँ	a eatable made of be gram flour
बढ़ई	carpenter
बढ़ई	carpenter; carpenter (wood)
बताशा	a dry sugar's sweet
बतासा	a semi spherical cake which is made of sugar and is very light and sponqy
बदमाशी	bullying
बंधन	bond
बंधन	Bond
बंधु	brother
बंधुत्‍व	brother-hood
बंध्‍या	barren [woman]
बन	assume
बन	be made
बनावट	architecture
बबलगम	Bubblegum
बबूल	acacia
बबूल	acacia tree
बम	bomb; bomb
बमकांड	Blasts
बरगद	banyan tree
बरछी	a day
बरफी	a kind of sweet
बराती	bridegroom's party
बरामदा	balcony
बलिहारी	affectionate blessings [on someone]
बलिहारी	bestow
बल्‍ब	bulb
बल्ब	bulb
बल्‍ला	bat
बल्‍ली	beam
बस	bus
बसूला	adz
बस्‍ता	bag
बहल	amuse
बहल	be amused
बहला	be amused
बहलाव	amusement
बहस	argument
बहस	argumet
बहादुर	brave
बहादुरी	bravery
बहिष्कार	Boycott
बहिष्‍कृत	boycotted
बहुत	abundant
बहुतायत	abundance
बाजी	bet
बाजूबंद	armlet
बाजूबन्‍द	Armlet
बांझ	barren
बाड़	boundry of plants
बाड़मेर	barmer
बाण	arrow
बाण	bolt
बाद	after
बादाम	almond
बांध	bind
बाधा	bar
बाम	balm
बारम्‍बार	again and agian
बारां	Baran
बालक	boy
बालटी	bucket
बालिश्‍त	a hand span
बांसवाड़ा	Banswara
बास्केटबाल	Basketball
बाहु	arm
बाहु	Brachium
बिक	be sold
बिछावन	bedding
बिछौ	bedding
बिफर	be visibly annoyed
बिलकुल	at all
बिल्‍कुल	absolute
बिल्‍कुल	absolutely
बिल्‍कुल	at all
बिल्‍ला	badge
बिल्‍वफल	Aegle Marmelos
बिश्‍नोई	a cast
बिस्‍कुट	biscuit
बिस्‍तर	bed
बिस्‍तर	bedding
बिस्‍तरबंद	bedding
बीकानेर	Bikaner
बीच	between
बीजक	bill
बीड़ी	bidi
बीत	be over
बीमारी	ailment
बीरबहूटी	a red velvety insect
बुझ	be extinguished
बुड्ढा	aged
बुदबुदा	bubble
बुद्धि	brain
बुद्धिमान	brilliant
बुरा	bad
बुराई	badness
बुराई	blame
बुर्ज	bastion
बुला	call
बूढा	aged
बूंदी	Bundi
बेजा	absurd
बेंत	cane
बेंत-प्रहार	canning
बेदाग	blameless
बेपरवाह	careless
बेफिक्र	careless
बेसुरा	absonant
बैंगन	brinjal
बैज	badge
बैंड-बाजा	Band
बैल	Bull
बैल	bullcok
बैल-समूह	bullock caravan
बैलगाड़ी	bullock cart
बैलगाड़ी	bullock-cart
बोआई	act of sowing
बोझ	burden
बोतल	bottle
ब्रश	Brush
ब्रह्मा	bharmha
ब्रह्मा	brahma
ब्रह्मा	Brahma
ब्राह्मण	Brahaman
ब्राह्मण	Brahmin
ब्रिचेज़	Breeches
ब्रुश	brush
ब्लाउज	blouse; blouse
ब्‍लाऊज	blouse
भगदड़	a noisy crowd
भड़भड़ाना	a sound
भतीजा	brother's son
भयंकर	awful
भयभीत	afraid
भयभीत	Afraid
भरती	admit
भरोसा	assurance
भरोसा	belief
भर्ती	admitted
भला	benefit
भलाई	benevolence
भवन	building
भँवरा	bumble-bee
भस्म	Ash
भस्‍म	ashes
भस्‍मी	ash
भा	be appealing
भाई	brother
भाग्यानुसार	according to luck
भाट	bard
भार	burden
भालू	bear
भिक्षा	alms
भिक्षा-पात्र	begging bowl
भिक्षापात्र	begging bowl
भिखारी	beggar
भिनभिना	buzz
भी	also
भीख	beg
भीग	be drenched
भीग	be wet
भीम	Bheem
भुजा	arm
भुन	be cashed
भुन	be parched
भुना	be parched
भूरा	Brown
भैंस	buffalo
भोंक	bark
भोथरा	blunt
भोंथरा	blunt
भौंक	bark
भौंक	bark; barking
भौंरा	bee
भौंरा	beetle
भौंरा	blackbee
भ्राता	brother
मक्‍खन	butter
मगजपच्‍ची	brain taxing
मगजपच्‍ची	brain-taxing
मंगनी	betrothal
मंगलघट	auspicious pitcher of water
मँगवा	bring
मच	be occasioned
मजाक	a joke
मंजूरी	approval
मटमैला	beige
मटमैला	brown
मं‍डी	agriculture market
मणि	a precious stone
मंथन	Brainstorm
मदार	a plant swallow-wort
मधुमक्‍खी	bee
मध्‍यस्‍थता	arbitration
मन-बहलाव	amusement
मनका	bead
मनका	Bead
मनबहलाव	amusement
मनभावन	beloved
मनमोहक	attractive
मनमौजी	capricious
मनाही	ban
मनाही	Ban
मनिहारा	bangle-seller
मनुहार	adulation
मर	be pacified
मल्‍लाह	boat man
मशवरा	advice
मस्‍तिष्‍क	brain
मस्तिष्‍क	Brain
महंत	Abbot
महत्त्वाकांक्षा	ambition
महत्त्वाकांक्षी	ambitious
महत्‍वाकांक्षी	Ambitious
माँ	amma
मांग	ask [for]
मांग	beg
मांगलिक	auspicious
मांझी	Boater
मान	accept
मान	admit
मान	agree
मानो	as
मानो	as if
मानो	As if
मार	beating
मारपीट	assault
मारपीट	battery
मारपीट	beating
मालदड़ी	a game which is played by a cloth ball, in which players hit each other by that ball; a cotton ball
मालपुआ	a flat cake of thin batter fried on both sides on a griddle
मावा	a sweetmeat of milk
मित्र	brother
मिमिया	bleat; A sound of a Goat or sheep
मिमियाहट	bleat
मिर्चीबड़ा	bondas of greeen chilli
मिलनसार	affable
मिला	add
मिला	blend
मिलान	act of collation; to mingle
मिलावट	adulterant
मिलावट	adulteration
मिलावटयुक्‍त	adulterated
मिलावटी	adulterated
मुकर	back out
मुकर	belie
मुक्केबाज़ी	boxing
मुक्त	acquitted
मुतसद्दी	agent
मुतसद्दी	assistant
मुनादी	anouncement
मुसीबत	afflication
मुसीबत	calamity
मुँहासा	Acne
मुंहासे	acne
मुहांसे	botch
मुहुर्त्त	auspicious moment
मुहूर्त	Actual time for auspicious beginning.
मुहूर्त्त	auspicious moment
मुहूर्त्त	auspicious time
मूमल	beautyful lady
मूर्ख	block head
मूलधन	capital
मृगछाल	buckskin
में	among
में	at
मेढ़	boundry
मेढी	a thatched room on the terrace
मेहराब	arch
मोड़	band
मोड़	bend
मोमबत्ती	candle
मोमबत्ती	Candle
मोरचा	a battle front
मोहक	attractive
मोहर्रम	a representation of the shrines of Hasan and Husain-sons of Ali [which in carried in procession at the Moharram by the Shias chiefly
मौज	caprice
मौजी	capricious person
मौनी	an ascetic who has taken a vow of silence
यग्‍य	an oblation
यजमान	a host; host
यति	ascetic
यथास्‍थान	appropriate place
यद्यपि	although
याद	bethink
युग	age
युद्द	battle
युद्ध	battle
युध्‍द	battle
युध्‍द-सामग्री	arms
युध्‍दक्षेत्र	battle-field
युध्‍दभूमि	battle field
युवा	budding youth
योगी	ascetic
योग्य	able
योग्‍य	able
योग्यता	ability
योध्दा	brave
योध्‍दा	brave
रईसी	Aristocratism
रक्त	blood
रक्‍त	blood
रक्त	Blood
रक्त-सम्बन्धी	blood relation
रक्‍तचाप	blood pressure
रक्तरंजित	bloodstained
रक्तरंजित	bloody
रक्‍तविहीन	bloodless
रखवाली	care
रगड़	abrasion
रंगरूप	Appearance
रज	ash
रज़ामंद	Agree with
रणक्षेत्र	battle field
रत	busy
रंभा	bellow
रसिक	amorous
रसिक-पुरुष	amorous
रसिया	amorist
राई	canola
राख	ash
राजी	Agree
राजीनामा	Agreement
राशि	amount
रिश्‍वत	bribe
रिश्वत	bribe
रिश्‍वतखोर	birbe taker
रिश्‍वतखोर	bribe-taker
रिश्‍वतखोर	bribetaker
रिश्‍वतखोरी	bribery
रिश्‍वतखोरी	Bribery
रुआंसा	about to weep
रुख	attitude
रुंध	be choked
रूप	beauty
रूपवती	Beautiful woman
रेंक	bray
रेजगारी	Broken money
रोक	bar
रोक	barrier
रोक	block [way]
रोगी-वाहन	Ambulance
रोब	awe
रोशनी	brightening
रौब	awe
लक्ष्‍य	aim
लक्ष्‍य	Aim
लक्ष्‍यहीन	Aimless
लग	be engaged in work
लगन	assiduity
लगभग	about
लगभग	approximately
लगा	affix
लगाम	bridle
लगाव	Affection
लगाव	attachment
लंघन	across
लचक	bend [under pressure]
लच्‍छी	a small skein of thread
लज्‍जा	Blush
लज्‍जाशील	bashful
लज्‍जित	ashamed
लज्जित	ashamed
लड़का	boy
लड़ाई	battle
लड्‍डू	a type of sweet
लड्‍डू	ball shaped sweetmeat
लत	Addiction
लथपथ	besmeared
लद	be laden [with fruits]
लद	be loaded
ललचा	allure
ललचा	be tempted
लवाजमा	accoutrements
ला	bring
लाइये	bring
लांछन	blame
लांछन	blemish
लाठी	big staff
लाठी	Blackjack
लाड़	caress
लाड़-प्‍यार	affection and love
लापरवाह	careless
लापरवाही	carelessness
लाभ	advantage
लाभ	benefit
लाभकारी	beneficial
लाभदायक	beneficial
लालसा	ambition
लाश	Body
लाश	carcass
लिप्त	besmeared
लीन	absorbed
लुट	be robbed
लुभा	attract
लुभाव	captivating
लुहार	blacksmith
लेकिन	but
लेख	article
लोक-नाटक	a popular play
लोकगीत	a folksong
लोकी	bottle gourd
लौकी	bootle guard; bottle gourd
वकील	advocate
वक्‍त-बेवक्त	at all times
वचनबध्‍द	bound
वचनबध्‍द	bound [by one's word]
वटवृक्ष	banyan tree
वरदान	boon
वर्णमाला	alphabet
वर्णसंकर	bastard
वर्णानुक्रम	Alphabet
वंश	ancestry
वसूला	adze
वस्‍तु	article
वस्‍त्र	a cloth
वातावरण	atmosphere
वापिस	again
वापिस	back
वायु	air
वायु	Air
वायुयान	aircraft
वायुयान	Ariplane
वार	bestow
वाला	a particle
वाला	a suffix denoting an agent
वास	abode
वाह-वाह	bravo
विकट	acute
विचारपूर्वक	after consideration
विच्‍छेद	breach; deserting
विध्‍वंसकारी	annihilative
विपत्ति	calamity
विमुख	adverse
वियोग	bereavement
विराम	break
विरुद	against
विरुद्ध	against
विरुद्ध	Against
विरुध्‍द	against
विरूद्ध	against
विरोध	antagonism
विवाद	altercation
विश्‍वास	belief
विश्‍वास	believe
विश्‍वासघात	betrayal
विश्‍वासी	A man who trusts easily.
वीणा	a musical instrument like gitar
वीर	brave
वीरता	braveness
वीरता	bravery
वीरता	Bravery
वीरत्‍व	bravery; heroic
वीरातिवीर	bravest
वृतात	account
वृतान्‍त	account
वृत्तान्‍त	account
वृत्तान्त	account
वृद्ध	Aged
वृध्‍दा	aged lady
वेणी	a woman's braided hair falling down on her back like a tail
वेद	Ayurvedic doctor
वेदना	agony
वैद्य	ayurvedic physician
वैर	aversion
वैरभाव	animosity
वैसे	By the way
व्‍यग्र	anxious
व्‍यग्रता	anxiety
व्यग्रता	Anxiety
व्‍यभिचारिणी	adulteress
व्‍यवसाय	bussiness
व्यवस्था	arrange; arrangement
व्‍यवस्‍था	arrangement
व्यवहार	Behaver
व्‍यवहार	behavior
व्‍यवहार	behaviour
व्यसन	addiction
व्‍यसन	addiction
व्यसनी	addict
व्‍यस्‍क	Adult
व्‍यापार	business
व्यापार	business
व्‍याभिचार	adultery
व्‍यावहारिक	behavioural
व्रध्द	aged
व्रध्‍द	aged
शकुनी	auger
शयनागार	bedroom
शय्‍या	bed
शरणागत	[one who has] come to seek shelter
शरमा	blush
शराब	alcohol
शराब	alcoholic liquor
शराबखाना	bra
शरीर	body
शर्त	bet; bet
शर्मिदा	ashamed
शर्मिंदा	ashamed
शर्मिन्‍दा	Ashamed
शस्‍त्र	arms
शह	backing
शहतीर	beam
शहनाई	a musical instrument
शाखा	branch
शाखाओं	branches
शांत	calm
शांति	calmness
शाबासी	a pat on the back
शाबासी	applause
शामियाना	canopy
शामिल	associated
शिखर	apex
शिल्‍पी	Artisan
शिवरात्रि	a special night of Lord Shiva
शिविर	camp
शिशु	baby; baby
शिशु	baby; child
शीघ्र	at once
शीघ्रता	acceleration
शीघ्रता	Apace
शीतलाष्‍टमी	a special day
शीर्ष	apex
शीशी	bottle
शुभ	auspicious; auspicious
शुरूआत	beginning
शूरवीर	brave
शेखी	boast
शेखी	boasting
शेरवानी	a marriage dress
शेष	balance
शोभा	Beauty
श्रृंगार	adornment
श्रेष्‍ठ	best
श्रेष्ठ‍	Best
श्‍वांस	breath
षड्यंत्र	cabal
षड्यन्त्र	cabal
संकट	calamity
संकोच	bashfulness
संकोची	bashful
सक्रिय	active
संक्षेप	abridged
संक्षेप	brief
सगाई	betrothal
सगोत्र	being of the same family
सचमुच	actually
सचेत	aware
सज	be decorated
सजग	alert
सजग	Alert
सजवा	be decorated
सजीव	animated; vivacious
संजीवनी	an elixir [said to restore the dead to life]
सटा	bring close
संतप्‍त	aggrieved
सतर्क	careful
सतर्कता	alertness
संताप	agony
संताप	anguish
संतोलिया	a type of game
संदूक	box
सन्‍दूक	box
संन्यासी	ascetic
संन्‍यासी	ascetic
सब	all
संबधित	affiliated with
सभा	assembly
सभी	all
समझौता	agreement
समर्थ	Able
समर्थ	capable
समस्‍त	all
समा	be contained [in]
समान	alike
समूह	a flock
समूह	band
समृध्‍दि	affluence
समोसा	a triangle shaped bonda
सम्‍मति	assent
सम्मुख	Afore
सम्‍हाल	care
सम्‍हाल	care; to take in one's charge
संयोगवश	by chance
सरसराहट	a sound of leaves
संलग्‍न	attached
सलाह	advice
सलेवड़ा	a type of papadum
सह	bear
सहमत	agree
सहयोग	assistance
सहायक	assistant
सहायता	aid
संहार	carnage
सहित	along with
सहेली	a woman's female companion or friend
साईकिल	bicycle
स़ांकली	a eatable made of wheat flour and jaggery
साक्षात	before [one's] eyes
साजिश	cabal
साँड	bull
सांड	bull
सादा	blank
साधु	ascetic
सामथ्‍र्य	ability
सामथ्‍र्य	capacity
सामने	ahead
सामर्थ्‍य	capability
सामर्थ्‍य	capacity
सामर्थ्य	capacity
सामर्थ्‍यवान	capable
सामर्थ्यवान	capable
सामान	accessories
सार	Abstract
सार-संभाल	care
साला	brother in law
सावचेत	attention
सावधान	alert
सावधान	careful
सावधान	Careful
सावधानी	alertness
सावधानी	attention
सावधानी	care
सावधानी	Careful
सावधानी	carefulness
सावा	auspicious time for marriage
सांस	breath
सांस	breathable; breath
साहब	boss
साहसी	bold
साहसी	Brave
साहूकार	banker
सिझा	boil
सिटकनी	bolt
सिद्धि	Accomplishment
सिध्‍दि	accomplishment
सिध्‍दि	attainment
सिफारिश	advocacy
सिरोपाव	an honor given by ruler
सिल-बट्टा	a stone pestle
सिवाय	avoid
सीख	advice
सीमा	border
सीमा	boundary
सीमा-चिन्‍ह	boundry mark
सुगंध	aroma
सुजाग	alert
सुटकेस	briefcase
सुथार	carpenter
सुंदरता	beautiful
सुधर	be corrected
सुन्‍दर	beautiful
सुन्‍दर	beauty
सुन्‍दरता	beauty
सुन्दरता	Beauty
सुन्दरी	belle
सुन्‍दरी	belle
सुपारी	betalnut
सुपारी	Betel nut
सुलझ	be disentangled
सुलझ	be solved
सुलझाड़ा	agreement
सुलझाड़ा	areement
सुश्री	bechler [f]
सुहा	be pleasing
सुहागिन	a woman whose husband is alive
सूझ	appear
सूरमा	antimony
सेंध	bulglary
सेना	army
सेम	bean
सेव	a salty preparation of gram-flour; apple
सेव	apple
सेवक	attendant
सेवा	attendance
सोख	absorb
सौंदर्य	beauty
सौदा	bargain
सौंफ	aniseed
सौभाग्‍य-वरदान	blessing for good fortune
स्तन	boob
स्तन	breast
स्‍तन	breast
स्‍तन	Breast
स्‍नान	bath
स्नान	Bath
स्नानघर	bathroom
स्‍नानघर	bathroom
स्‍नेह	affection
स्नेह	affection
स्‍नेहिल	affectionate
स्‍नेही	affectionate
स्‍याह	blackish
स्‍वत	automatically
स्‍वभाव	behaviour
स्‍वयं	by one's self
स्‍वार्थपूर्ति	attainment of one's interest
स्‍वास्‍तिक	an auspicious sign
स्‍वीकार	accept
स्वीकार	accept
स्‍वीकार	accept
स्‍वीकार	acceptance
स्‍वीकृत	accepted
स्वीकृति	acceptance
स्‍वीकृति	acceptantance
स्‍वेच्‍छाचारिता	arbitrariness
हज्‍जाम	barber
हठधर्मी	bigot
हठी	arrogant
हड़बड़ा	be confused
हड्डियां	bones; bones
हड्डी	bone
हब्‍शी	African black man
हमला	attack
हमेशा	always
हरकत	action
हरगिज	[not] at all
हरा	beat
हलका	area
हलचल	bustle
हलवा	a special Indian pudding made of flour, suji, milk, sugar, ghee etc.
हल्‍कापन	buoyancy
हवा	air
हवाईजहाज	aeroplane
हंस	awan
हाय	alas
हार	be defeated
हाव-भाव	airs and graces
हावभाव	amorous
हितकर	beneficial
हिमायत	backing
हिसाब	account
हुकुंम्‍ब	calabash
हूँ	am
हृष्ट-पुष्ट	able-bodied
हृष्‍ट-पुष्‍ट	Athletic
हेराफेरी	bungling
हैरान	amazed
हो	be
हो	become
होशियार	alert
हौवा	bogey
ह्रष्‍ट-पुष्‍ट	able-bodied
