á	ah (dismissively)
a baja	his/her problem
a barátommal	with my friend
abbahagy	quits / stops
ablak	window
abszolút mértékben	absolutely
abszolút (nem)	absolutely (not)
addig	until there/until then
-ad/ed	te (past tense, definite)
ad	gives
-(a/e)k	add to adjective to form plural
-(a/e)n	add to adjective to from adverb (a, e endings lengthened to á, é)
-a/e	ő/ön/maga (past tense, definite)
áfonya	blueberry
afrikai	African
aggódik	worries
a gyerekek könyvei	the children's books
a gyerekemnek	to my child
a gyerek kicsi	the child is small
ahány	the number of which (relative pronoun)
ahol	where (relative pronoun)
ahonnan	from where (relative pronoun)
ahova	towards where (relative pronoun)
ajándék	gift
ajándékozik	gives as a gift
ajánl	recommeds / offers
ajtó	door
akár ... is	even
akar	wants
-ák/ék	ők/önök/maguk (past tense, definite)
-ak/ek	ők/önök/maguk (past tense, indefinite)
a kis gyerek	the small child
aki	who (relative pronoun, considered front vowel word)
akkor	then; well then
a közelben	in the neighborhood / nearby
alacsony	low / short (height)
aláír	signs (one's signature)
a lányuk	their daughter
alaposan	thoroughly
alatt	under; during
albérlet	apartment for rent/sublet
-ál/él	te (past tense, indefinite)
alkalom	occasion
államhatalom	powers of state
állampolgár	citizen
állampolgárság	citizenship
áll	stands
alma	apple
alól	from under
álom	dream
alszik	sleeps
általában	usually
Alternatív Közgazdasági Gimnázium	Alternative Economics High School
aludni	to sleep
a magyar leckémben	in my Hungarian lesson
-am/em	én (past tense, indefinite & definite)
amennyi	the amount of which (relative pronoun)
Amerikába	to America
ami/(a)mely/amelyik	which, that (relative pronoun, considered front vowel word)
amíg	while
amikor	when (relative pronoun)
amint	as
angol	English
angol tagozatos gimnázium	secondary school specialising in English
angolul	in English
annak	to/for that
annyira	so much so
annyi	so much
antikvárium	second-hand bookshop
antropológus	anthropologist
április	April
apróhirdetés	classified ad
apropó	that reminds me/by the way
aranyos	cute; darling
arc	face
árleszállítás	price reduction
ár	price
áru	product (á)
asszisztens	assistant / nurse
asszony	Mrs.
asszonyom	ma'am
ásványvíz	mineral water
asztali	of a table
asztali számítógép	desktop computer
asztal	table
átad	hands over
a táskája	his/her bag
átlagos	average
átmegy	goes over/across
-átok/étek	ti (past tense, definite)
-atok/etek	ti (past tense, indefinite)
attól függ, hogy	it depends...
átvesz	takes (over)
augusztus	August
autó	car (a)
automata	vending machine
a villamosra	onto the tram
az a baj, hogy...	the problem is...
az anyja	his/her mother
az anyjuk	their mother
az apja	his/her father
az apjuk	their father
azaz	in other words / that is to say
az az olasz táska piros.	That Italian bag is red.
az az ő pénze	That is his money
az az ő pénzük	That is their money
azért	that's why, for that reason
aznap	that day
az öccse	his/her younger brother
az öccsük	their younger brother
az öcséd	your (sing.) younger brother
az öcsém	my younger brother
az öcsénk	our younger brother
az öcsétek	your (pl.) younger brother
azoknak	to/for those
azok	those / they
azonban	however
azonnal	immediately
az orvoshoz	to the doctor's office
azóta	since then
aztán	then
azután	then/after that
azzal (avval)	with that
bab	bean
-ba/be	into (inside & hova: motion towards)
baj	problem; trouble
bajusz	moustache
ballagás	graduation ceremony
balra	on/to the left
banán	banana
-ban/ben	in (inside & hol: no motion)
bánik	minds / cares
bankautomata	ATM (longer)
bank	bank
bankomat	ATM (shorter)
bárány(hús)	lamb
barát	friend
barátnő	girlfriend/female friend
bárcsak	if only
bármikor	anytime
barna	brown
bár	though
bátorság	courage
bátya	older brother
be akarok menni a boltba	I want to go into the store
beédesít	sweetens
beépített	built-in
befejez	finishes
befordul	turns in(to)
begombol	buttons up
be-	in, into (coverb)
bejárat	entrance
bejár	travels through
bejelentkezik	checks in / registers
bekapcsol	turns on
beköltözik	moves in (to an apartment/home)
belemegy	goes into
belenéz	looks into
belép	steps in/enters
beleszeret	falls in love with (with -ba/-be)
belső	inner
belvárosi	downtown
bélyeg	stamp
bemutat	introduces
benéz	looks in / pops in
bent	inside
bérház	apartment building
bérlet	season ticket
beszélek	I speak
beszélget	chats
beszél	he/she/you speak
beszélnek	they/you all speak
beszél	speaks
beszélsz	you speak
beszéltek	you all speak
beszélünk	we speak
beteg	ill (adj) / patient (noun)
betesz	puts in
beugrik	pops in
beül	sits into
bevall	admits / confesses
bevásárlás	shopping (groceries) (b)
bír	endures / withstands
bizony	surely / indeed
biztos, ami biztos	just to be on the safe side
biztosan	surely
biztos	sure(ly)
bocs(i)	Excuse me (informal)
boka	ankle
-ból/ből	out of, from (inside & honnan: motion from)
bölcső	cradle / crib
boldog	happy
bolt	store
böngészik	browses
borító	(book) cover
borjú(hús)	veal
borjúpaprikás	veal in paprika sauce
bőrönd	suitcase
borosüveg	wine bottle
borozó	wine bar
borravaló	tip (lit: 'for wine')
borsó	pea
bor	wine
brazíliai	Brazilian
brokkoli	broccoli
budapestig	as far as Budapest
Budapestre	to Budapest
büfé	snack bar
buli	party
burgonya	potato (used on menus)
busz	bus
ceruza	pencil
cetli	slip of paper
cigaretta	cigarette
cím	title
cinege	titmouse
cipő	shoe(s)
citrom	lemon
_ colos	_ inches
comb	thigh
csak nem	you don't mean...! / not...!
csak úgy	just like that
családi név	family name
csarnok	hall / arena / marketplace
csatlakozik	joins up with
csavargó	wanderer
cseh	Czech
cseresznye	cherry
csésze	cup
csinál	does/makes
csípőcsont	hipbone
csípő	hip
csirke(hús)	chicken
csodák csodájára	wonder of wonders
csodálkozik	is amazed/surprised (with -(o/e/ö)n)
csodás	wonderful
csók	kiss
csokoládé	chocolate
csókolom	Hello/Goodbye ('I kiss your hand'; men to women or children to adults; respectful)
csokor	bouquet
csokor	bunch/bouquet
csomagol	wraps
csomag	package
csukló	wrist
csúnya	ugly
csupa veríték	all covered in sweat
csütörtök	Thursday
cukor	sugar
dal	song
darab	piece
darab	piece / play
december	December
dehogynem	(but) of course (for negative questions)
dehogy	of course not/not at all (for affirmative questions)
de, (igen)	(but) yes!
De jó!	How great! / That's great!
deka	decagram (10 grams)
dél/délben	noon/at noon
délelőtt	(in the) forenoon
dél	south/noon
délután	(in the) afternoon
derék	waist
desszert	dessert
diák	student
digitális	digital
dinnye	melon
divatjamúlt	out of fashion
Dobos torta	sponge cake topped with caramel slices
doboz	box
dolog	thing
dönt	decides
drága	expensive
drága	expensive / dear
dugó	cork
dzsámi	mosque
dzsida	lance
ebédel	eats lunch
ebéd	lunch
ébred	wakes up
ébren	awake
eddig	until here/until now
édesanya	mother (e)
édesség	sweets / dessert
édes	sweet
edz	coaches/trains
egészségére	To your health! Cheers! (formal)
egész	whole
Egri Bikavér	a full-bodied Hungarian red wine
Egri Bikavér	Bull's Blood (wine from Eger)
egy	1
egyágyas	single room
egyáltalán nem	not at all
egyedül	alone
egyelőre	for the time being
egyenesen	straight
egyéniség	individual
egyes	the one
egyetemista	college student
egyetem	university
egy-két	a few
egy kicsit	a little (adverb)
egykori	former
egymás	each other
egyszer	once
egyszerűen	simply
egyszerű	simple
egyszobás	studio apartment
együttes	band / group
együtt	together
éhes	hungry
éjfél/éjfélkor	midnight/at midnight
éjfél	midnight
éjjel	(at) night (j)
éjszaka	(at) night (z)
éjszaka	night
éjszakára	for (a) night
ekkor/akkor	at this/that time
eladó	sales clerk
elájul	faints
el-	away/will (coverb)
elbeszélget	chats at length
elefánt	elephant
elegem van	I've had enough
elég	enough
elég	quite; fairly
elég	rather / fairly
elénekel	sings (through)
elengedi magát	lets oneself go / relaxes
elenged	lets go
elér	achieves
elgondolkodik	thinks over
elhatároz	decides
elhisz	believes
elhív	invites
elindul	sets off / departs
eljön	comes along
elkészít	prepares
elkészül	gets ready
elkezd	begins / starts
elküld	sends off/away
ellenőriz	checks
ellenőr	(ticket) inspector
ellenség	enemy
él	lives
elmagyaráz	explains
elmegy	goes / sets off for
elmesél	relates / tells
elmond	tells (the whole story)
elmúlt	past
elnézést kérek/bocsánatot kérek	Excuse me (more formal with k)
előadás	performance
előadó	performer
előbb	earlier
élőben	live / in person
előétel	appetiser
elöl	at the front
elolvas	reads (all the way through) (e)
először	first(ly)
előtt	before
elront	spoils / ruins
elsétál	walks (all the way) to
első	1st
első	first
ELTE	Eötvös Loránd University
eltervez	plans
eltéveszt	misses (aim)
el tudja készíteni a számlát	he is able to prepare the bill
elutazik	travels
elvesz	takes away
élvezetes	enjoyable / plesant
elvisz	takes (along)
emailezik	emails
emancipáció	emancipation
ember	person/man
emelet	floor (of a building)
emlék	landmark relics
emlékszik	remembers (with -ra/-re)
énekel	sings
énekes	singer
engem	me (accusative, but indefinite)
én	I
Én is!	Me too!
ennek a mérete	the length of this
ennek	to/for this
enni	eat (infinitive)
ennyire	so much so
ennyi	so much
én _ vagyok	I am _
eper	strawberry
eposz-trilógia	epic trilogy
épp(en)	just/exactly
épület	building
érdekel	interests (fleeting vowel verb)
érdekeljük	we interest him/her (he is interested in us)
érdekes	interesting
érdeklik	they interest him/her (he is interested in us)
erdély	Transylvania
erdő	forest
eredetileg	originally
érettségizik	graduates (from secondary school)
érez	feels / senses
érkezés	arrival
érkezik	arrives
értenek	they/you all understand
érteni	to understand
értesz	you understand
értetek	you all understand
-ért	"for (as in ""for the purpose of"", ""to fetch"", or in financial transactions)"
érthető	comprehensible
ért	understands
esemény	event
esetleg	perhaps
este	(in the) evening
észak	north
eszembe jut	comes to (my) mind
eszik	eats
étlap	menu
étterem	restaurant
ett-	"past tense stem of ""eszik"""
étvágy	appetite
európai	European
Európai Unió (EU)	European Union (EU)
EU-s	of the EU
_ éves	_ years old
evett	he/she was eating
évszak	season
év	year
ezeknek a gyerekeknek a könyvei	these children's books
ezeknek	to/for these
ezek	these
ezenkívűl	in addition to this
ezer	1, 000
ezért	this is why, for this reason
ezredik	1000th
ezres	the thousand
ezt meg lehet csinálni	it is possible to do it
ezüst	silver
ezzel (evvel)	with this
fagylalt	ice cream
fáj	hurts
fantasztikus	fantastic
fapad	wooden bench
fa	tree/wood
fázik	is cold
február	February
fehér	white
fej	head
fejsze	axe
felad	(sends by) post
feláll	stands up
felébreszt	wakes up
fél füllel hallottam, hogy...	"I happened to overhear that... (lit. ""I hear with half an ear that..."")"
fél	half
felhív	calls up
felhőkarcoló	skyscraper
felirat	sign / notice
fél	is afraid (with -tól/-től)
felismer	recognises
felkel	gets up
fellép	performs
felnőtt	adult
fél nyolc (f8)	half past seven
felől	from the direction of
felszáll	gets on
féltékeny	jealous
fel-	up (coverb)
felvesz	enroll; puts on
felvesz	picks/takes up
fent	above; upstairs
fényképezőgép	camera
fénykép	photo
férfiak	men
férjhez megy	gets married (of a woman only)
fesztivál	festival
fiatalkori	of youth
fiatal	young
film	film
filmrendező	film director
findzsa	pot
finn	Finnish
finom	delicious
finom	delicious (fine, refined, tasty)
fiú	boy
fiútestvér	brother
fizet	pays
foci	soccer
fodrász	hairdresser
főétel	entrée
fogás	course
fog	holds, takes
fogja a pártját	takes the side of / supports
foglal	books (verb)
foglalkozás	profession
foglalkozás	profession / job
fog	tooth
fog	will (forms future tense)
fokhagyma	garlic
földalatti	subway
földszint	ground floor
fölé	over / above
fölött	above
folyosó	corridor
főnök	boss
fontos	important
főposta	main post office
fordít	translates
fordul	turns
forradalom	revolution
forró	hot / boiling
fotó	photo
főz	cooks
főzelék	vegetable soup/puree
főzöl	you cook
francia	French
friss	fresh
függőfolyosó	corridors in interior courtyards
fülcimpa	earlobe(s)
fül	ear
furcsa	strange
fürdő	bath
fürdőszoba	bathroom (f)
fut	runs
fuvar	ride
füzet	notebook
Gábornak nagy családja van	Gábor has a large family
galuska	special kind of noodle
garancia	warranty
gép	machine (or airplane)
gigabájtos	having/with gigabytes
gimnázium	secondary school
gitár	guitar
gitáros	guitarist
gomb	button
gomb	button
gombóc	dumpling
gondolkodás	thinking
gondolkozik	thinks / ponders (with -(o/e/ö)n)
gondol	thinks
gond	worry; care
görög	Greek
gőzfürdő	steam bath
gőz	steam
gulyás	goulash
Gundel palacsinta	type of thin pancake
gyakran	often
gyanús	suspicious
gyengén	poorly
gyerek	child
gyermekkori	(of) childhood
gyógyfürdő	thermal bath
gyönyörű	wonderful
gyórgyszer	medicine
gyorsan	quickly
gyors	fast
gyors	fast/express
gyulai kolbász	Gyulai smoked sausage
gyümölcs	fruit
gyümölcsök	fruits
hadd	let! (always with the subjunctive)
hagy	leaves / lets
hagyma	onion
ha	if
haj	hair
hajol	bends
hal	fish
hallgat	listens (to)
hall	hears
haló	hello/goodbye (on the phone)
hálószoba	bedroom
hamarosan	before long / soon
hamar	soon
hanem	but / rather (corrective)
hangos	loud
hang	voice
hány?	how many?
hány órakor?	at what time?
hány óra van?	what time is it? (h)
harmadik	3rd
harmadik	third
hármas	the three
harminc	30
harmincadik	30th
harmincas	the thirty
harmincegyedik	31st
három	3
háromnegyed	three quarters
háromnegyed tizenkettő (hn12)	quarter to twelve
has	abdomen
hasonló	similar
használ	uses
hat	6
hat	affects
hatalmas	huge; enormous
határidőnapló	appointment book
hatással van	has an effect on (-ra/-re)
hát	back
hátizsák	backpack
hatodik	6th
ha törik, ha szakad...	"no matter what (lit. ""whether it breaks or tears"")"
hatos	the six
Hatszor Hat Taxi	6x6 taxi company
hátul	at the back
hatvan	60
hatvanadik	60th
hatvanas	the sixty
hát	well...
havi	monthly
hazaér	arrives / gets home
haza	homeland
hazamegy	goes home
haza	towards home
ház	house
házi feladat	homework
házmester	superintendent
hegy	mountain
helyet foglal	takes a seat
helyett	instead of (postposition)
helyi	local
hely	place
helyzet	situtation
hentesáru	meat products
hess le!	shoo!
hét	7
hetedik	7th
hetes	the seven
hétfő	Monday
hétfőn	on Monday
hétre	for (a) week
hétvége	weekend
hetven	70
hetvenedik	70th
hét	week / seven
hiányzik	is missing
hideg	cold
hídfő	bridge abutment
hihetetlen	unbelievable
hinni	to believe/think
híres	famous
hír	news
hirtelen	suddenly
hisz	believes/thinks
hitt-	"past tense stem of ""hisz"""
hivatalos keretek között	officially
hivatalos	official
hív	calls
hívlak	I'll call you
hőemelkedés	low fever
hogy-hogy?	what do you mean?
hogy	how
Hogy mondják magyarul?	How do you (lit. they) say in Hungarian?
hogy tetszik	how do you like...
hogy	that (conjunction)
holnap találkozunk	See you tomorrow
holnap	tomorrow
holnapután	day after tomorrow
hol	where
homlok	forehead
hónap	month
honlap	homepage/webpage
honnan?	where from?
hordár	porter / bellboy
hordozható	portable
horvát	Croatian
hosszú ideig	for a long time
hosszú	long
hova?	towards where?
hoz	brings
-hoz/hez/höz	towards (nearby & hova: motion towards)
hozzátok	You all bring it
húg	younger sister
húsfélék	meat types
hús	flesh / meat
húsz	20
huszadik	20th
húszas	the twenty
huszonegyedik	21st
huszonkettedik	22nd
huszonkilenc	29
-i	add to place name to form adjective
idead	hands/gives here
idejön	comes here
idenéz	looks here
ide	towards here
ide-	towards here (coverb)
időben	on time
időjárásjelentés	weather report
időpont	specific time
idő	weather; time
idulás	departure
-id	your (sing.) (plural object; vowel ending a, e to á, é; consonant ending: add -(j)a/(j)e- )
igazad van	you are right
igazán	truly
igazgató	director
igazi	true/real
igazság	truth
-ig	until/up to (a time or location)
igyekszik	tries / strives
így is	even so; thus
így	thus / so
-i	his/her/its (plural object; vowel ending a, e to á, é; consonant ending: add -(j)a/(j)e- )
-ik	their (plural object; vowel ending a, e to á, é; consonant ending: add -(j)a/(j)e- )
illat	fragrance
ilyenkor	at such time(s)
ilyen	such
imád	adores/loves
íme	here you are
-im	my (plural object; vowel ending a, e to á, é; consonant ending: add -(j)a/(j)e- )
indul	sets off
információ	information
ingatlanközvetítő	estate agent
ing	shirt
inkább magyarul beszél, mint németül.	She prefers to speak Hungarian rather than German.
inkább olvasok	I prefer to read.
inkább	preferably, rather
-ink	our (plural object; vowel ending a, e to á, é; consonant ending: add -(j)a/(j)e- )
innen	from here
inni	to drink
integet	waves (verb)
internetezik	uses/surfs the internet
ínycsiklandozó	appetising
irodalom	literature
iroda	office
író	writer
írta	he/she was writing it
ír	writes
is	also (directly after subject)
ismer	knows/is familiar with
ismerős	acquaintance (noun) / familiar (adj)
ismét	again
isten	god
iszik	drinks
ital	drink
itallap	drinks menu
-itok/itek	your (pl.) (plural object; vowel ending a, e to á, é; consonant ending: add -(j)a/(j)e- )
itt	here
itthon	at home (spoken when you're at home)
itthonról/otthonról	from home
itt-	"past tense stem of ""iszik"""
ivott	he/she was drinking
íz	flavor / taste
izgalmas	exciting
izgatottan	nervously / worriedly
ízlik	tastes good
-ja/i	ő/maga/ön (definite)
-(j)a/(j)e	his/her/its (single object; vowel ending a, e to á, é)
jajj	yikes/oh no
-ják/ik	ők/magak/önök (definite)
januárban	in January
január	January
japán	Japanese
jár	goes with / attends
járókelő	pedestrian
játékzongora	toy piano
-játok/itek	ti (definite)
játszik	plays
javaslom	I recommend it
javasolja	he recommends it
javasol	recommends (fleeting vowel verb)
javul	improves
jéghideg	ice-cold
jegypénztáros	ticket clerk
jegypénztár	ticket window
jegy	ticket
jelen	present; here
jobban	better (adverb)
jobb későn, mint soha	Better later than never.
jobbra	on/to the right
jobbulást	Feel better!
jó éjszakát kívánok	Good night! (formal/informal; always as a farewell)
jó éjt	Good night! (shorter; formal/informal; always as a farewell)
jó estét kívánok	Good evening!
jogász	lawyer
jóga	yoga
joghurt	yogurt
jó	good
jóízű	delicious (palatable, tasteful)
jó kedvem van	I'm in a good mood
jókedvűen	in a good mood
jól áll valakinek	looks good on someone (á)
jól érzi magát	feels good/well; has a good time
jól hangzik	sounds good/great!
jól ismerlek	I know you well
jól megy valamihez	goes will with something
jól néz ki valakin	looks good on someone (n)
jól	well (j)
jó napot kívánok	Good day/afternoon!
jó napot kívánok!	Hello/Good day!
jön	comes
jön-megy	comes and goes
jönnek	they come
jönni	to come
jó pihenést!	"Have a good holiday! (lit. ""Have a good rest!"")"
jó reggelt kívánok	Good morning!
jössz	you come
jót tesz	does (one) good
jöttök	you all come
jött-	"past tense stem of ""jön"""
jó utat!	Have a good trip!
jövö	future; next
jövök	I come
jövünk	we come
-juk/jük	mi (definite)
-(j)uk/(j)ük	their (single object; vowel ending a, e to á, é)
július	July
június	June
jutalom	reward
jut	gets to (a place)
kacag	laughs loudly
kacsa	duck
kacsint	winks
kakaóscsiga	chocolate bun
kakas	rooster
kalap	hat
kaliforniai paprika	bell pepper
kanadai	Canadian
kanalak	spoons
kanál	spoon
kancsó	pitcher
kap	gets/recieves
káposzta	cabbage
kapucsengő	entrance hall
karácsony(i)	(of) Christmas
karácsonykor	at Christmas
kar	arm(s)
karfiol	cauliflower
kártya	card
kávé	coffee/espresso
kávéház	café
kávézás	coffee-drinking
kávézik	drinks coffee
kávézó	coffee shop (k)
kedd	Tuesday
kedvel	likes
kedvenc	favorite
kedves	nice; kind (k)
kedves valakitől	is nice of someone
kedv	mood
kefír	sour yogurt
kehely	cup, chalice
kék	blue
kelet	east
keleti	eastern
kellemes	pleasant
kellemes ünnepeket	happy holidays
kell	is necessary / must
kel	rises / gets up
kényelmes	comfortable
kenyér	bread
kényes	delicate
képeslap	postcard
képmutató	hypocritical
kép	picture
kép	picture/image
képzeld!	Imagine!
képzelet	imagination
képzel	imagines
kér	asks for; requests; would like
kérd	asks
kérdés	question
kérdez	asks
kérek szépen	May I please have
kérem	you're welcome (very formal)
kérem	You're welcome (very formal, somewhat old-fashioned)
keres	looks for
keresztnév	forename
kerület(i)	district (adj.)
késésben van	is late
késik	is late
kés	knife
később	later
késő	late
készít	prepares/makes
készül	prepares/readies (for)
két/kettő	two
kétszobás	two-room (one-bedroom) apartment
kettes	the two
kezd	begins
kezdődik	begins
kéz	hand(s)
kézipoggyász	carry-on bag
kézírás	handwriting
kiadó	for rent
kicsoda	who (emphatic)
kiért?	for whom?
ki ez?	Who is this?
kifelé menet	on the way out
kifizet	pays up
kifli	crescent-shaped roll
kigombal	unbuttons
kijárat	exit
kijelzőméret	screen size
kijön	comes out
kikapcsolódás	relaxation
kikapcsolódik	relaxes
kik ezek?	Who are they?
kilenc	9
kilencedik	9th
kilencedik	ninth
kilences	the nine
kilencezer-kilenc	9009
kilencszázkilencven	990
kilencven	90
kilencvenedik	90th
kilencvenkilenc	99
kilép	steps out
kimegy	goes out
kimerült	exhausted
kínai	Chinese
kinek a tolla?	whose pen?
kinő	grows out of
kint	outside
kinyit	opens
kiolvas	reads (all the way through) (k)
ki-	out (coverb)
kipróbál	tries out
kirakat	shop window
kisasszony	Ms.
kitisztít	(dry)cleans
kiválaszt	selects
kiváló	excellent
kivel?	with whom?
kivesz	takes out
kivételes	exceptional
kizárólag	exclusively
koccint	clinks glasses
kockán forog	"is at risk (lit. ""spins on a cube"")"
kocsi	car
kocsma	bar/pub
kolbász	sausage
köldök	navel
kolléga(nő)	(female) colleague
költő	poet
komolyra fordítva a szót	to speak seriously
komoly	serious
kompjuter	computer (k)
kondicionálóterem	exercise room / gym
könnyen	easily
könnyű	easy
konyha	kitchen
könyök	elbow(s)
könyörög	pleads / begs
könyörül	has mercy upon
könyv	book
könyvesbolt	bookshop
könyvmoly	bookworm
korán	early
-kor	at (a time)
köret	side dish
környék	neighborhood
körözött	spiced cottage cheese
korsó	mug / pint
körte	pear
korty	sip
körülnéz	looks around
körút	boulevard [in Budapest, ringroad]
kösz/köszi	Thanks. (informal)
köszönöm szépen	Thank you very much.
köszönöm	thank you
kosztüm	(matching) skirt and jacket
köt	ties; associates with
kövér	fat
következő	following / next
közben	in the meantime
közel áll	is fond of (lit. stands near) (-hoz/-hez/-höz)
közeli	close/near
közelség	nearness / proximity
középen	in the middle
közül	from among
krumpli	potato (used in speech)
kulcs	key
küldenek	they/you all send
küldeni	to send
küldesz	you send
küldötök	you all send
küld	sends
külföldi	foreign(er)
külöben is	anyway; otherwise
különböző	different/various
különleges	special
különösen	especially
kutat	searches
kutya	dog
küzd	struggles
láb	foot/feet; leg
lábú	foot(ed)
lábujj	toe
lakás	apartment
lakásközvetítő	estate agent
lakik	he/she/you live (also dict form)
lakik	lives; dwells
-lak/lek	én with object téged (you) or titeket/benneteket (you all)
lakom	I live
lámpa	lamp/light
lámpa	traffic light
lánnyal	with a girl
lány	girl
lánytestvér	sister
lap	postcard
laptop	laptop
lassú	slow
látlak	I see you
lát	sees
látszik	seems / appears
láz	fever
lead	hands in / delivers
leánykori név	maiden name
lecke	lesson
lecsó	letcho (pepper stew)
le-	down (coverb)
lefoglal	reserves
legépel	types up
légiutaskísérő	flight attendent
legyen szíves	Please (formal)
légy szíves	Please (informal)
lehetetlen	impossible
lehet	is possible
lekésik	is late for
lélegzet	breath
lemegy	goes down
lemerül	runs down (of a battery)
lemez	album
lengyel	Polish
lenni	will be (infinitive)
lent	down; below
lényeg	esstial thing; point of the matter
lépcső	stairs
lép	steps
leszakad	tears / breaks
lesz	will be
letesz	puts down
lett-	"past tense stem of ""lesz"""
leugrik	jumps down
leül	sits down
levegő	air
levélírás	letter-writing
levél	letter / document
leves	soup
levesz	takes off
levetkőzik	undresses
liba	goose
lift	elevator
lila	purple
limonádé	lemonade
lop	steals
madár	bird
magához tér	revives / comes to one's senses
maga mit képzel?	What are you thinking? (as when someone cuts in line)
magam sem	not even I
magánügyi	private
magassarkú	high-heeled
magas	tall
maga	you (formal; can carry familiar or neg connotations)
maguk	you all (formal; can carry familiar or neg connotations)
magyaráz	explains
magyarország	Hungary
majd	soon / later
majd	soon/later/then
máj	liver
május	May
mákos kifli	poppy-seed roll
málna	raspberry
marad	stays / remains
már	before, already
március	March
marha(hús)	beef
marhapörkölt	beef stew
máris	already / right away
márka	brand
már nincs/már nem	no longer
másik	(the) other
második	2nd
más	other; else
ma	today
meddig?	(for) how long?
meddig tart?	how long does it last?
medence	pool
megad	gives
megállapodik	agrees upon / sets / fixes
megálló	(bus or tram) stop
meg	and
megárt	hurts / harms
megátkozik	curses
megbeszél	discusses / reaches an agreement
megbeszélés	meeting
megbeszélt	agreed-upon
megbízható	reliable
megebédel	has lunch
még egy	yet another
megél	lives (on) / survives / gets by
megérdemel	deserves
megérkezik	arrives (m)
megért	understands
megetet	feeds
megfelel	is suitable
megfog	grasps
meggondolja magát	changes one's mind
meggyógyul	gets well
meggyőz	convinces s.o. of s.t.
meghallgat	listens to (meg optional)
meghatódik	is touched by
meghívás	invitation
meghív	invite
megijeszt	frightens / scares
megint	again
megírta	he/she wrote it
megír	writes
még ... is	even; yet (...)
megismer	gets to know / learns
megismerkedik	becomes acquainted (with)
megiszik	drinks (up)
megjelenik	gets published / appears
megkedvel	takes a liking to
megkér	asks / requests
megkeres	looks for and finds
megkíván	has a desire for / craves
megköszön	thanks
meglátogat	visits
meglepetés	surprise
meglepődik	is surprised
megmarad	remains
megmér	measures (meg optional)
még mindig	still
megmond	says / states
megmozdul	moves / budges (meg optional)
megmutat	shows
még nem	not yet
megnéz	has a look at
megpróbál	tries
megreggelizik	has breakfast (m)
megrendel	places an order (m)
meg ... sem	not even
még	still; yet
megszólal	speaks up / begins to speak
megszólít	addresses
megtalál	finds
megtapogat	taps
megúszik	gets out of a tough spot easily (figurative)
megvan	has got/owns
megvár	waits for (until the arrival)
megver	beats
megvesz	buys
megvesz	buys (m)
megvirrad	dawns; day breaks
megviszgál	examines (meg optional)
meg-	will complete (coverb)
megyek	I go
megy	he/she/it goes
megyünk	we go
mekkora?	how big?
melegem van	I am (too) hot
meleg	warm
mell	chest
mellé	(towards) next to
mellett	next to
mély	deep
melyik?	which (one)?
mennek	they go
menni	to go
mennyi az idő?	what time is it? (m)
mennyibe kerül?	How much does ... cost?
mennyiért?	for how much?
mennyi?	how much?
Mennyi lesz?	How much will it be?
mennyire	how much (so)
mennyivel tartozom?	How much do I owe you?
mentek	you all go
ment-	"past tense stem of ""megy"""
merevlemez	hard drive
merre?	where/which way?
mert	because
mesél mindez	rells / relates all this
mesél	tells about
messze	far
mész	you go
metró	metro
metróval	by metro
mexikói	Mexican
mező	field
miatt	because of
mi bajod van?	what is your problem?
micsoda?	what (kind of)?
mielőtt	before (conjunction)
miénk	ours
miért mosolyogsz a bajuszod alatt?	"What is that grin on your face? (lit. ""Why are you smiling under your moustache?"")"
miért?	why?
mi ez?	What is this?
mik ezek?	What are these?
mikor?	when?
millió	1, 000, 000
milyen színű?	what color?
milyen?	what kind of?
mindegy	it's all the same (to me); it doesn't matter
minden	every; everything
mindenhova	(towards) everywhere
minden jót	all the best
mindenképp(en)	in any case/by all means
mindenki	everyone
minden rendben	Everything is okay.
mindez	all this
mindig	always
mindjárt	right away / immediately
mindketten	both (adverb)
mindkettő	both
miniszterelnök	prime minister
minket/bennünket	us (accusative, but indefinite)
mintha	as if
mint	than
mi(t) is	what (emphatic)
Mit parancsol?	What would you like? (asked by shopkeepers)
mit szólsz?	What do you think?
miután	after (conjunction)
mi _ vagyunk	we are _
mivel?	with what?
mi	we
mi	what
mobilszám	cell phone number
mobil(telefon)	cell phone
modell	model
mögött	behind
mond	tells/says
mormog	mumbles
mormota	marmot
mosdó	rest room
mosolyog	smiles
mostanában	nowadays
most már nem úszod meg!	"You can't get out of it so easily now! (lit. ""You can't swim it."")"
most	now
mozaik	mosaic
mozi	cinema
múló	passing / momentary
múltkor	recently
múlt	past
munkahely	workplace
munka	work
műsorfüzet	programme/playbill
műszaki	technical
mutatja a képünket	She is showing our picture
mutat	shows
művész	artist
múzeum	museum
nadrág	pants
nád	reed / thatch
nád	thatch
nagybácsi	uncle
nagy	big / high / great
nagymama	grandmother
nagynéni	aunt
nagyon szívesen	You're very welcome.
nagyon	very
nagypapa	grandfather
nagyszerű	excellent/wonderful
nagyszülő	grandparent
nagyszülők	grandparents
-nak/nek	dative ending (lengthen a and e to á and é at ends of nouns)
-nak/nek/nek	ők/magak/önök (indefinite; verbs ending in ít/2 consonants: link with a/e)
-nál/nél	at, near, by (nearby & hol: no motion)
nap	day/sun
nap/nappal	day/during the day
naponta	daily / per day
napszakok	times of day
narancs	orange (fruit)
narancssárga	orange (color)
narancsszínű	orange (orange-colored)
na	well
nedves	wet / damp
ne fesd az ördögöt a falra	"Don't even think it because it may just happen! (lit: ""Don't paint the devil on the wall!"")"
négy	4
negyed három (n3)	quarter past two
negyedik	4th
negyed óra múlva	in fiften minutes
negyed	quarter
négyes	the four
négy óra	four o'clock
négyre	by four (o'clock)
negyven	40
negyvenedik	40th
negyvenes	the fourty
néhány	several
nehéz	difficult; hard; heavy
nehéz fába vágtum a fejszémet	"I took up a difficult task (lit ""I slammed my axe into a tough tree!"")"
ne igyál előre a medve bőrére!	"Don't count your chickens before they hatch! (lit. ""Don't drink to the skin of the bear in advance!"")"
neked	to/for you
(nekem) fel kell adnom ezeket a lapokat	I have to post these cards
nekem	to/for me
(nekik) nem kell bemenniük	they don't have to go in
nekik	to/for them
neki	to/for him, her, it
nektek	to/for you all
nekünk	to/for us
nélkül	without
német	German
nem is	not even
nem kizárt	it's not out of the question
-né	Mrs (word ending)
nem történt semmi	Nothing happened (response to apology)
nem tudom	I don't know
nép	folk / people / nation
népzene	folk music
netán	perhaps / by change
névnap	name day
...névre	for the name of...
néz	looks
néz	looks at/watches
-ni	infinitive ending (stem + ni = to _; verbs ending in ít/two consonants: link with -a/e)
nincsenek bőröndjeink	we have no suitcases
nincsenek	(they, you formal) are not
nincs	(he/she/it) is not
nincs mit	"You're welcome. (lit. ""for nothing"")"
nincs poggyászod?	Don't you have a bag?
nincs sok pénzem	I don't have much money
nocsak	well, well... (informal)
nos	well (n)
nóta	(popular) song
november	November
nővér	older sister
nő	woman
nulla	0
nyak	neck
nyaraló	summer cottage
nyár(i)	summer(y)
nyáron	in the summer
nyárs	skewer
nyár	summer
nyelvérzék	feel for language(s)
nyelviskola	language school
nyelv	language / tongue
nyelvtan	grammar
_ nyelvű	in language _
nyílik	opens
nyit	opens
nyitva	open
nyolc	8
nyolcadik	8th
nyolcas	the eight
nyolcvan	80
nyolcvanadik	80th
nyom	presses
nyugat-afrikai	West African
nyugat	west
öcs	younger brother
odaad	gives / hands (over)
odalép	steps over
odamegy	goes towards
oda	towards there
oda-	towards there (coverb)
odavezet	leads towards
-od/ed/öd	te (definite)
-od / ed / öd	your (sing.) (single object; vowel ending a, e to á, é)
ő	he; she
- ok /ek / ök	add to noun to form plural
-ok/ek/ök	én (indefinite)
őket/önöket/magukat	them/you all formal (accusative, and definite)
okos	smart
ők	they
október	October
ők _ vannak	they are _
olasz	Italian
olaszország	Italy
olcsó	inexpensive
-ol/el/öl	te (indefinite; only verbs ending in s, sz, z)
öltöző	dressing room
olvasni	to read
olvasol	you read
olvas	reads
olvassa	S/he reads it
olyan	as/so
-om/em/öm	én (definite)
-om/em/öm	én (-ik verbs only; remove -ik from all endings except ő/maga/ön before conj)
-om / em / öm	my (single object; vowel ending a, e to á, é)
-on / en / ön	on, at (outside & hol: no motion)
ön/maga _ van	you are _ (formal)
onnan	from there
önnek/magának	to/for you (formal)
önök/maguk _ vannak	you all are _ (formal)
önöknek/maguknak	to/for you all (formal)
önök	you all (polite)
ön	you (polite)
operációs rendszer	operating system
Opera	the opera house in Budapest
óra	clock
óra	clock (parking meter)
öreg	old (of animated)
őriz	guards
örök	eternal
orosz	Russian
orr	nose
ország	country
örül	is glad/is happy
örülök, hogy megismertelek	Nice to meet you (informal)
örülök, hogy megismertem	It is nice to meet you (formal)
orvos	doctor
összebarátkozik	makes friends (with)
összeesküvés	conspiracy
összefut	runs into
összefut	runs into (with -val/-vel)
összeg	sum
ősszel	in the autumn
összesen	all together
összes	whole / entire
ősz	autumn
őszibarack	peach
őszintén	honestly
öt	5
ötlet	idea
ötödik	5th
-(o)tok/(e)tek/(ö)tök	your (pl.) (single object; vowel ending a, e to á, é)
őt/önt/magát	him/her/it/you formal (accusative, and definite)
ötös	the five
-ott /ett / ött	past tense marker (long form)
otthon	at home (spoken when you're not at home)
ott	there
ötven	50
ötvenedik	50th
ötvenes	50-forint coin
ő _ van	he/she is _
öv	belt
övtáska	belt pouch/fanny pack
pad	bench
padló	floor
palacsinta	thin pancake / crepe
pálinka	Hungarian spirit
pályaudvar	railway station
pályázat	application
panasz	complaint
papagáj	parrot
papír	paper
papír	paper / document
papírpénz	banknote
paprika	paprika/pepper
paprikás	(s.t.) containing paprika
paradicsom	tomato
parancsol	orders/commands
pardon	Excuse me! (either formal/informal)
párizsi	bologna
Párizs	Paris
parkol	parks
pár	pair
part	shore
patyolat	drycleaners
pecsenye	roast meat
pedig	"and / but / however / ""on the other hand"""
pékáru	baked goods
pékség	bakery
például	for example
pendrive	flash drive / pen drive
péntek	Friday
pénzérme	coin
pénz	money
pénztár	cash register
perc	minute
_ perc múlva	in _ minutes
Petőfi Csarnok	a cultural market in Budapest
piac	market
pihen	rests
pillanat	moment
pincér	waiter
piritós	toast (bread)
piros	red (p)
pluzus	pulse
pogácsa	scone/patty/biscuit
poggyászkiadás	luggage claim
poharak	drinking glasses
pohár	drinking glass
polc	shelf
politika	politics
pontos	exact
poros	dusty
porta	concierge's desk
portás	doorman
postaláda	postbox
posta	post office
presszó	coffee shop (p)
próbál	tries
probléma	problem
program	programme
pult	counter
pulyka(hús)	turkey
ráadásul	moreover
rábeszél	persuades
rádió	radio
Radnóti Miklós	theatre in Budapest
rágyújt	lights up (a cigarette)
rájön	realises
rajtakap	catches in the act
-ra/re	onto, to (outside & hova: motion towards)
rászáll	flies on to / alights
rátalál	comes across / hits upon / finds
rávág	slams onto (with -ra/-re); gives quickly
recept	prescription / recipe
regény	novel
reggeli	breakfast / morning
reggel	(in the) morning
reggelizem	I eat breakfast
reggelizik	eats breakfast
reggelizik	he/she/you eat breakfast (also dict form)
régi	old (of inanimates)
régóta	for a long time
remélem	I hope (so)
remélem, találkozunk még!	I hope we meet up again!
remél	hopes
remény	hope
rendelés	order/booking/reservation
rendelő	office (of a doctor)
rendet csinál	tidies up
rendkívül	extraordinary
rend	order/orderliness
rendőr	policeman
reptér	airport
reptéri transzfer	airport shuttle
repülő(gép)	airplane
reszket	trembles
részlet	detail
rétes	strudel
rettenetesen	terribly/awfully
ribizli	currant
rögzítő	answering machine (short)
rohan	rushes
-ról/ről	off, from (outside & honnan: motion from)
roma	person of Roma origina
romkocsma	'ruined' pub (trendy pub often in abandoned buildings)
rom	ruin
rossz	bad
rövid	short (length)
rózsaszínű	pink
ruha	clothing / dress / cloth
saját	own
sajnos	unfortunately
sajt	cheese
saláta	lettuce/salad
saláta	salad
sárgabarack	apricot
sárgadinnye	cantaloupe
sárgarépa	carrot
sárga	yellow
sárga	yellow
sarok	corner
segít	helps
segítség	help
sehol nem/sem	nowhere
sejt	guesses
selyem	silk
semmi baj	No problem (response to apology)
semmi gond	No worry/trouble (response to apology)
semmi nem/sem	nothing
sem ... sem	neither ... nor
senki nem/sem	nobody
sertés(hús)	pork
sétál	walks/strolls
siet	hurries
siker	success
sikerül	succeeds
sík	flat / plain
sincs	is neither
sms	text message
sofőr	driver
sokáig	for a long time
sokat	a lot (adverb)
sok	much; many (followed by a singular)
sokszor	often/frequently
somolyog	smirks
sonka	ham
sör	beer
sor	line / queue
söröző	beer bar
sötét-	dark (use w/color)
sőt	moreover
sovány	thin / lean / skinny (s)
spanyolul	in Spanish
spenót	spinach
sport	sport(s)
sporttáska	sportsbag
srác	guy
stem	ő/maga/ön (indefinite)
stem	ő/ön/maga (past tense, indefinite)
súg	whispers
sűrűn	densely (frequently)
süt	bakes
sütemény	pastry
svájci	Swiss
svéd	Swedish
Szabad a taxi?	Is the taxi available?
szabadidő	free time
szabadság	holiday
szabó	tailor
száj	mouth
szak	major (in school)
szalad az idő	time flies
szalagavató	formal dance in the last year of secondary school
szalámi	salami
szalámis	with salami; salami flavored
száll	flies
szállj le rólam!	Get off my back! Come on, stop it!
szálloda	hotel
szállodaportás	concierge
szállodavendég	hotel guest
szalonna	bacon
szalonnasütés	Hungarian style BBQ with bacon
szál	thread, link (pl: -ak)
szalvéta	napkin
számítógép	computer (s)
számla	bank account
számla	bill/receipt
szám	number
száraz	dry
származású	(of a certain) heritage
szárnya	wing(s)
száz	100
századik	100th
százas	100-forint coin
szédül	feels dizzy
szék	chair
szél	edge
széles	wide
szellő	breeze
személyesen	in person
személy	person
szem	eye(s)
szemfedő	shroud
szemöldök	eyebrow(s)
szempilla	eyelash(es)
szempilla	eyelashes
szemüveg	(eye)glasses
szendvics	sandwich
szenegáli	Senegalese
szénsavas	carbonated
szénsavmentes	non-carbonated
szenved	suffers
szép	beautiful
szép	beautiful / nice
szépen	nicely/kindly (s)
szeptember	September
szerda	Wednesday
szerelem	love
szeretek táncolni	I like to dance.
szeret	likes; loves
szeretnék	I would like...
szerető	lover
szerintem	I think [that]...
szervusz	Hello/Goodbye (informal, old-fashioned)
szervusztok	Hello/Goodbye (plural, informal, old-fashioned)
szerzödés	contract
szia	hi/bye (familiar)
szia	Hi/Bye (informal)
sziasztok	Hi/Bye (informal, plural)
Sziget	annual summer music festival in Budapest
sziget	island
szilva	plum
szimpatikus	nice / kind / friendly
szín	color
színlelés	pretence
színlel	pretends
színpad	stage
-színű	-colored (ie orange-colored)
színű	(having a) color; colored
szívesen	gladly/happy to
szívesen	gladly / with pleasure
szívesen	you're welcome
szívesség	favor
szív	heart
szobafoglalás	room reservation
szoba	room
szög	nail
szokásos	usual
szoknya	skirt
szólít	addresses
szőlő	grape
szól	says / utters
szombat	Saturday
szomorú	sad
szomszédban	next-door
szomszéd	neighbour
szorít	is tight/pinches
szörnyű	awful
szótár	dictionary
szóval	so... / well...
szöveg	text
-sz	te (indefinite; verbs ending in ít/2 consonants: link with -a/e)
szükség	necessity
születésnap	birthday
születésnap(i)	birthday (adj.)
születik	is born
szülő	parent
szürke	grey
tábla	(black)board
taktika	tractic
talál	finds
találkozás	meeting / gathering
találkozik	meets; gets together
talán	perhaps (with the connotation of hope)
támogatás	support
tánc	dance (noun)
táncol	dances
tanfolyam	course / training
tanítanak	they/you all teach
tanítani	to teach
tanítás	teaching
tanítasz	you teach
tanítotok	you all teach
tanít	teaches
tanterem	classroom
tanulás	study/studying
tanul	studies
tányér	plate
tarhonya	egg barley
tarka	multicolored
tárkony	tarragon
társaság	company
tartalmaz	contains
tart	holds, keeps, goes on, lasts
tartózkodik	stays / resides
táska	handbag / backpack
tatarozás	renovation
tavasszal	in the spring
tavasz	spring
távol	distance
távozik	departs
taxiállomás	taxi stand
taxis	taxi driver
taxi	taxi
teázik	drinks tea
téged	you (accusative, but indefinite)
téglaépület	brick building
tegnapelőtt	day before yesterday
tegnap kiolvastam	yesterday I read
tegnap olvastam	yesterday I was reading
tegnap	yesterday
tejes káve	latte (coffee)
tejföl	sour cream
tej	milk
tejszín	cream
tejtermékek	dairy products
telefonál	calls/telephones
telefonkártya	phone card
telefonszám	phone number
telefon	telephone
tele	full
télen	in the winter
telik	is filled / passes
téliszalámi	'winter' salami
teljesen	fully / completely
teljes	full / complete
tél	winter
téma	topic / theme
tenyér	palm / flat of the hand
tényleg	really
térd	knee
teremtés	creation (here: creature, person)
térkép	map
termék	product (t)
természetesen	of course/naturally
terv	plan
tessék	I'm listening / go ahead / excuse me / what did you say?
test	body
testvér	sibling
tesz	puts
teteje	its roof
tető	roof
tetszik	likes (lit. 'is pleasing to')
tett-	"past tense stem of ""tesz"""
te _ vagy	you are _ (familiar)
te	you (familiar)
tikárnő	secretary
titeket/benneteket	you all (accusative, but indefinite)
titkol	keeps a secret / hides
titok	secret
ti _ vagytok	you all are _ (familiar)
ti	you all (familiar)
tíz	10
tizedik	10th
tizenegyedik	11th
tizenharmadik	13th
tizenkettedik	12th
tizenkilenc	19
tizes	the ten
tízórai	elevenses
tízóraizik	eats elevenses
tíz percig	for ten minutes
többiek	(the) others
több	more
több	several
tojás	egg
tök	squash
-tok/tek/tök	ti (indefinite; verbs ending in ít/2 consonants: link with -o/e/ö)
tó	lake
toll	pen
tolmácsol	interprets
tölt	fills / pours
-tól/től	away from (nearby & honnan: motion from)
töltött	stuffed
tölt	spends (time)
tolvaj	thief
törökül	in Turkish
történelem	history
történelmi	historic
történész	historian
törülköző	towel
tovább	further
további jó utat	Have a good (continuation of your) trip
-t	past tense marker (short form)
troli	trolley
tucat	dozen
tud	he/she/you know
tud	knows; knows how; can
tudnak énekelni?	Do they know how to sing?
tudnak	they/you all know
tudok	I know
tudsz	you know
tudtok	you all know
tudunk	we know
tükör	mirror
tükörtojás	fried egg sunny side up
tulajdonképpen	actually
túlságosan	too / excessively
túl	too / excessive
turistacsoport	tourist group
turista	tourist
túró	cottage cheese
túrós táska	cheese pastry
tűz	fire
uborka	cucumber
üdvözlöm	How do you do? / Welcome!
ugrik	jumps
úgy alszik mint egy mormota.	"He sleeps like a log. (lit. ""He sleeps like a marmot."")"
ugyanaz	the same
ugyanis	because
ugye?	isn't that right?
ügyes	clever / savvy / Good job!
ügyfélszolgálat	customer service
ügy	matter
úgy néz ki	it looks as though...
ügynök	agent
úgy tűnik, hogy...	it seems that...
ujj	finger
új	new
újra	again
újság	newspaper
-uk/ük	mi (past tense, definite)
ül	he/she/you sit
ülnek	they/you all sit
ülök	I sit
ül	sits
ülsz	you sit
ültök	you all sit
-ul/ül	express in a language (language + _)
ülünk	we sit
unalmas	boring
-unk/ünk	mi (past tense, indefinite)
- unk / ünk	our (single object; vowel ending a, e to á, é)
-unk/ünk/ünk	mi (indefinite)
ünnepi	formal
unoka	grandchild
unokatestvér	cousin
uram	sir
úr	Mr.
USB csatlakozó	USB port
úszik	swims
uszoda	swimming pool
utál	hates
utána	afterwards
után	after
utas	passenger
utazás	trip
utazik	travels
utca/út	street
útikönyv	travel guide
útközben	on the way
útlevélellenőr	passport officer
útlevélellenőrzés	passport control
útlevél	passport
utónév	first name
üt	strikes
üveg	bottle
üzenet	message
üzenetrögzítő	answering machine
üzen	sends the message
üzlet	store/business
űzött	persecuted
uzsonna	afternoon snack
uzsonnázik	eats afternoon snack
vacsora	dinner
vacsorázik	eats dinner
vágány	platform
vág	cuts
vág	cuts / slams
vagyis	or; that is to say
vagy	or
vaj	butter
vajon	I wonder (at beginning of question)
vakáció	holiday
valahogy	somehow
valahol	somewhere
valaki	someone
valakit valamiről	someone about something
valami	something
válasz	answer
válaszol	replies / answers
választ	chooses
váll	shoulder(s)
válogat	selects / chooses
valójában	actually / really
-val/vel	with/by (consonant endings: initial -v turns into double consonant ending)
van	(he/she/it) is
vannak	(they) are
van	to be
vár	castle
várja	He/she/you wait (for something)
várják	They/you all wait (for something)
várjátok	You all wait (for something)
várjuk	We wait (for something)
várlak	I'm waiting for you
várod	You wait (for something)
várókozik	waits
várom	I wait (for something)
város	city
városnézés	sightseeing (in the city)
váróterem	waiting room
várszínház	Castle Theatre
vár	waits (for)/expects
vásárlás	shopping (v)
vasárnap	Sunday
vásárol	shops (for)
vas	iron
váza	vase
végigsétál	walks along/promenades
végig	through
végre	finally
vékony	slim / thin (v)
Velencei tó	lake near Budapest
véletlen	coincidence
véletlenül	by chance / accidentally
véle	with him/her (archaic)
vendég	guest
vendéglő	restaurant (v)
vendégségbe megy	goes to visit someone's home
vendégségben van	is a guest at someone's home
vénülő	ageing
vérnyomás	blood pressure
verseskötet	collection of poems
vers	poem
vérző	bleeding
vesszük	We buy it
vesz	buys/gets
veszel	you buy
vet	tosses
vett-	"past tense stem of ""vesz"""
vezetéknév	surname
vezet	leads on
viccelődik	jokes / kids around
vicces	funny
vidám	cheerful
videókamera	video camera
videóklipp	video clip
világos	light (colored)
világos-	light (use w/color)
világ	world
világzene	world music
villa	fork
villamos	tram/street car
virág	flower
virsli	frankfurter; hot dog
visszaérkezik	arrives back
visszafordul	turns back
visszahív	calls back
visszajáró	change
visszajön	comes back
visszamegy	goes back
visszanéz	look back (in) / drop back in
visszatelefonál	calls back
viszhall!	goodbye (coll., on the phone only)
viszlát	Bye! (formal/informal)
viszonthallásra!	goodbye (hall)
viszontlátásra	Goodbye! (formal)
viszont	on the other hand
visz	takes/carries
vitt-	"past tense stem of ""visz"""
víz	water
volt-	"past tense stem of ""van"""
vonat	train
vörösáfonya	cranberry
vöröshagyma	(yellow) onion
vörös	red (with nature, geography, companies, politics/Communism)
wincseszter	winchester hard drive
zakó	jacket
zászló	flag
zavarba jön	gets embarrased
zeller	celery
zenekar	orchestra / band
zene	music
zeneszám	song/piece of music
zenész	musician
zöld	green
zöld paprika	green pepper
zöldségek	vegetables
zöldség	vegetable
zongorázik	he/she/you play the piano (also dict form)
zongorázik	plays the piano
zongorázom	I play the piano
zseb	pocket
zsemle	round crusty roll
Zsófiának meg kell várnia a barátját	Zsófia has to wait for her friend
