-ne (interrogative suffix)	**begins a question
-que	and
-que (conj.)	and (attached to the end of the second word)
-que (enclitic conj.)	and (appended to the end of the second word in the series)
a, ab (prep.) + (ablative)	from, away from, by
a, ab + (abl.)	by, away from, from
ab (prep.) + (ablative)	away from, from, by
abeo, abire, abii, abitus	to go away, depart
abest	he/she is out, is absent
abiit	perfect - he/she went away
abit	he/she goes away
absum, abesse, abfui, abfuturus	to be out, be away, be absent
accēpit	perfect - he/she accepted, received
accido, accidere, accidi, -	to fall upon, happen, alight, occur
accipio, accipere, accepi, acceptus	to take
accipio, accipere, accepi,acceptus	to take, grasp, receive, accept
accipit	he/she accepts, receives
acer, acris, acre (adj.)	sharp, keen, eager, severe, fierce
acerbus, acerba, acerbum (adj.)	harsh, bitter, sharp
ad	to
ad (prep.)	to
ad (prep.) + (accusative)	to, up to, near to
adeo (adv.)	to such a degree, so much, so greatly, precisely, exactly
adeo, adire, adii, aditus	to approach, attack, visit, address
adeptus, adepta, adeptum (adj.)	having received, having obtained
adest	he/she is here
adiuvo, adiuvare, adiuvi, adiutus	to help, aid, encourage, favor
administro, administrare, administravi, administratus	to manage
adsum, adesse, adfui, adfuturus	to be here, present
adulescens, adulescentis M/F	young man, young woman
adulescentia, adulescentiae F.	youth, youthfulness
advēnī	perfect - he/she arrived
adveniō	he/she arrives
advenio, advenire, adveni, adventus	to come to, arrive, reach
adventus, adventus M	arrival, approach, visit, appearance
aedificium	building
aedificium, aedificii N.	building, edifice, structure
aedifico, aedificare, aedificavi, aedificatus	to build, erect, construct, make, create
aeger, aegra, aegrum (adj.)	sick, ill, injured, corrupt, sad
aeger, aegrum	sick, ill
aequus, aequa, aequum (adj.)	level, even, calm, equal, just
aetas, aetatis F.	period of life, life, age, time, era
ager, agri M.	field, farm
agit	he/she does
agitat	he/she chases, hunts
agitāvit	perfect - he/she chased, hunted
agito, agitare, agitavi, agitatus	to chase, hunt, drive, control, pursue
agmen, agminis N.	column (of people), procession, stream, herd, flock, troop, crowd
agnōscit	he/she recognizes
agnosco, agnoscere, agnovi, agnitus	to recognize, realize, discern, acknowledge, claim
agnōvit	perfect - he/she recognized
ago, agere, egi, actus	to do, urge, conduct, deliver(speech)
ago, agere, egi, actus	to drive, lead, do, act, pass, spend
agricola	farmer
agricola, agricolae M.	farmer
agricola, agricolae M.	farmer
ait, aiunt (defective verb)	he or she says, they say (ASK ME ABOUT DEFECTIVE VERBS!)
aliquid	something
aliquid (pronoun)	something
aliquis (pronoun)	someone, anyone, a few, some, any
aliquis, aliquid	someone, somebody, something
alius, alia, aliud (adj.)	other, another, different, changed
alius, alia, aliud (adj)	other, another
alo, alere, alui, altus	to nourish, support, sustain, increase, cherish
alter, altera, alterum (adj.)	second, another, other
alter, altera, alterum (adj.)	the other, second
alter, alterum	the other, the second
altus, alta, altum (adj.)	tall, high
ambulat	he/she walks
ambulo, ambulare, ambulavi, ambulatus	to walk
amica, amicae F.	friend
amica, amicae F.	friend
amicitia, amicitiae F.	friendship
amīcus	friend
amicus, amica, amicum (adj.)	friendly
amicus, amici M.	friend
amicus, amici M.	friend
āmīsit	perfect - he/she lost
āmittit	he/she loses
amitto, amittere, amisi, amissus	to lose, send away, dismiss, let go
amo, amare, amavi, amatus	to love, like
amo, amare, amavi, amatus	to love, like (amabo te = please)
amor, amoris M.	love
amor, amoris, M.	love
ancilla	slave-girl
ancilla, ancillae F.	slave-girl, slave woman
anima, animar F.	soul, spirit, life, wind, air
animal, animalis N.	animal
animus, animi M.	mind, intellect, soul, spirit, character
animus, animi M.	soul, spirit, mind
annus, anni M.	year
annus, anni, M.	year
ante (prep) + (accusative)	through, by
antea (adv.)	before, before this, formerly, previously
antiquus, antiqua, antiquum (adj.)	ancient, old
ānulus	ring
anulus, anuli M.	ring
aperio, aperire, aperui, apertus	to uncover, open, disclose, explain, reveal
apodytērium	changing room
appareo, apparere, apparui, apparitus	to appear, be evident, show up, occur
appello, appellare, appellavi, appellatus	to speak to, address, call, name
appropinquo, appropinquare, appropinquavi + (dative)	to approach, come near to, be close
apud	among, at the house of
apud (prep) + (accusative)	among, at the house of
aqua, aquae F.	water
aqua, aquae F.	water, sea, lake, river, stream
ara, arae F.	altar, sanctuary, refuge
arcesso, arcessere, arcessivi, arcessitus	to send for, summon, fetch, invite
ardeo, ardere, arsi, arsus	to be on fire, burn, blaze, flash, glow
argumentum, argumenti N.	proof, evidence, argument
ars, artis f.	art
ars, artis F.	art, skill
arx, arcis F.	citadel, stronghold
ascendo, ascendere, ascendi, ascensus	to climb, rise, ascend
Asia, Asiae F.	Asia
asper, aspera, asperum (adj.)	rough, harsh
at (conj.)	but
āthlētās	athletes
atque (or ac) (conj.)	and, also, even
ātrium	atrium, entryway, waiting room
atrium, atrii N.	atrium, reception hall
attonitus	astonished
attonitus, attonita, attonitum (adj.)	astonished, fascinated, stupefied, dazed
auctor, auctoris M.	author, originator
auctoritas, auctoritatis, f.	authority
audax, audacis (adj.)	bold, daring
audeo, audere, ausus sum (semi-deponent)	to dare
audeo, audere, ausus sum (semideponent verb)	to dare, risk, venture, intend
audio, audire, audivi, auditus	to hear, listen to
audio, audire, audivi, auditus	to hear, to listen to
audit	he/she hears, listen to
auditor, auditoris M.	hearer, listener, member of an audience
aula	palace
aula, aulae F.	hall, temple, palace
aureus, aurea, aureum (adj.)	golden, made of gold
auris, auris f.	ear
auris, auris F.	ear
autem (conj.)	but, however, moreover
autem (conj)	but, on the other hand, while, however, moreover
auxilium, auxilii N.	help, assistance, remedy/antidote
avārus	miser
avarus, avara, avarum (adj.)	greedy, avaricious
avarus, avari M.	miser
avide (adv.)	eagerly
barbarus, barbari, M.	barbarian, stranger
basium, basii N.	kiss
beatus, beata, beatum (adj.)	happy, fortunate, blessed
bellum, belli N.	war
bellus, bella, bellum (adj.)	pretty, handsome, charming
bene (adv.)	well
bene (adv.)	well, very, quite, rightly
bene, melius, optime (adv.)	well
beneficium, beneficii N.	benefit, kindness, favor
benignus, benigna, benignum (adj.)	kind
bibit	drink
bibo, bibere, bibi, bibitus	to drink
bonus	good
bonus, bona, bonum (adj.)	good, honest, brave, noble, kind
bonus, bona, bonum (adj.)	good, kind
brevis, brevis, breve (adj.)	short, small, brief
cado, cadere, cecidi, casus	to fall, sink, drop, plummet,end, cease
caedo, caedere, cecidi,caesus	to kill
caelum, caeli N.	sky, heaven
caelum, caeli, N.	sky, heavens
Caesar, Caesaris M.	Caesar
caldārium	hot room
callidus	clever, smart
callidus, callida, caladium (adj.)	clever, skillful, smart, cunning
canis	dog
canis, canis M/F	dog
cantāre, cantāvī	perfect - he/she sang
cantō	he/she sing
canto, cantare, cantavi, cantatus	to sing
capio, capere, cepi, captus	to take, seize, grasp, arrest, capture
capit	he/she takes
captivus, captivi M.	prisoner, captive
caput, capitis N	head, person, leader, heading
caput, capitis N.	head, leader, beginning
carcer, carceris M.	prison
careo, carere, carui, carutus (+ abl.)	to be without, be deprived of, want, lack, be free from
carmen, carminis N.	song, poem, charm
Carthago Carthaginis F.	Carthage
carus, cara, carum (adj.)	dear
carus, cara, carum (adj.)	dear, beloved, precious
casa, casae, F.	house, cottage, hut
castigo, castigare, castigavi, castigatus	to scold, nag, chastise, punish
castra, castrorum N. (plural)	military camp, fort
causa, causae, F.	cause, reason, case, situation
cedo, cedere, cessi, cessus	to give in, to give way, to cede, to yield
celebrat	he/she celebrates
celebrāvit	perfect - he/she celebrated
celebro, celebrare, celebravi, celebratus	to celebrate, honor
celer, celeris, celere (adj.)	fast, swift, quick, rapid
celeriter	quickly
celeriter (adv.)	quickly
celo, celare, celavi, celatus	to hide, conceal, keep secret
cēna	dinner
cena, cenae F.	dinner
cēnat	he/she eats dinner, dines
cēnāvit	Perfect - he/she ate dinner, dined
ceno, cenare, cenavi, cenatus	to dine
ceno, cenare, cenavi, cenatus	to dine, have dinner
centum (indeclinable) (adj.)	a hundred
centuriō	centurion, roman soldier
centurio, centurionis M.	centurion
cēpit	perfect - he/she took
cēra	wax, wax tablet
cera, cerae F.	wax, wax tablet
cerno, cernere, crevi, cretum	to distinguish, discern, perceive
certamen, certaminis N	struggle, contest, fight, competition
certus, certa, certum (adj.)	definite, sure, certain, reliable
cēterī	the others, the rest
ceterus, cetera, ceterum (adj.)	the other, the rest
cibus	food
cibus, cibi M.	food
Cicero, Ciceronis M.	Cicero
cinis, cineris M/F/N	ashes, embers
cinis; cinerem	ash
circum + (acc.)	around
circumspectat	he/she looks around
circumspecto, circumspectare, circumspectavi, circumspectatus	to look around
cīvis	citizen
civis, civis M/F	citizen
civis, civis M/F	citizen
civitas, civitatis F.	state, citizenship
clāmat	he/she shouts
clamo, clamare, clamavi, clamatus	to shout
clāmor	shout, uproar
clamor, clamoris M.	shout, uproar, applause, clamor
clarus, clara, clarum (adj.)	clear, bright, renowned, famous, illustrious
clarus, clara, clarum (adj.)	famous
claudo, claudere, clausi, clausus	to close, shut, block up, finish, enclose
clementia, clementiae F.	mildness, gentleness, mercy
coepio, coepere, coepi, coeptus	to begin, commence, initiate
cogito, cogitare, cogitavi, cogitates	to think, consider, ponder, imagine
cogito, cogitare, cogitavi, cogitatus	to think, ponder, consider, plan
cognosco, cognoscere, cognovi, cognitus	to get to know, become acquainted with, recognize
cogo, cogere, coegi, coactus	to force, compel, collect, gather, convene
colloco, collocare, collocavi, collocatus	to place, put, arrange, station, post
colloquium, colloquii N.	talk, chat
comes, comities M/F	comrade, companion, associate, partner
commemoro, commemorare, commemoravi, commemoratus	to mention, recall
committo, committere, commisi, commissus	to entrust, commit
commodus, commoda, commodum (adj.)	convenient, suitable, favorable
communis, communis, commune (adj.)	common, general
comparo, comparare, comparavi, comparatus	to compare, provide, prepare, acquire, obtain
compleo, complere, complevi, completus	to fill, finish, complete
complet	he/she fills
complēvit	perfect - he/she filled
comprehendo, comprehendere, comprehendi, comprehensus	to arrest
conficio, conficere, confeci, confectus	to make, construct, complete, finish
confido, confidere, confisus sum (semi-deponent) + (dat.)	to trust, believe, rely on
coniurati, coniuratiorum m. (plural)	conspirators
coniūrātiō, coniūrātiōnem	plot
coniuratio, coniurationis F.	conspiracy, plot
conscendo, conscendere, conscendi, conscensus	to climb on, to mount
consentio, consentire, consensi, consensus	to agree, plot, conspire, consent
conservo, conservare, conservavi, conservatus	to preserve, conserve, maintain
consilium, consilii N.	debate, discussion, deliberation, counsel
consilium, consilii N.	plan, purpose, counsel, advice, judgement, wisdom
consisto, consistere, constiti, constitus	to stop, stand, halt, pause, linger
cōnspexit	Perfect - he/she caught sight of
conspicatus, conspicata, conspicatum (adj.)	having caught sight of
conspicio, conspicere, conspexi, conspectus	to catch sight of, spot
cōnspicit	he/she catches sight of
consul, consulis M.	consul
cōnsūmit	he/she eats
consumo, consumere, comsumpsi, consumptus	to eat, burn up, destroy, consume
cōnsūmpsit	perfect - he/she ate
contendit	he/she hurries
contendo, contendere, contendi, contentus	to hurry, compete, contend, strive for
contentus	satisfied
contentus, contenta, contentum	satisfied, content, pleased
contineo, continere, continui, contentum	to hold together, to contain, to keep, to enclose
contra (prep. + acc.)	against
convenio, convenire, conveni, conventus	to gather, meet, come together, visit
convenit	gathers; meets or gathered; met
copia, copiae F.	abundance, supply
copiae, copiarum F. (plural)	supplies, troops, forces
coquit	he/she cooks
coquo, coquere, coxi, coctus	to cook
coquus	cook
coquus, coqui M.	cook
cornu, cornus n.	horn
corpus, corporis N.	body
cotīdiē	every day
cotidie (adv.)	daily, every day, day by day, usually
cras (adv.)	tomorrow
crēdidit	dative - to trust; to believe
crēdit	trusts; believes
credo, credere, credidi, creditum (+ accusative or dative)	to believe, trust
credo, credere, credidi, creditus	to trust, entrust, believe, trust in, confide
creo, creare, creavi, creatus	to create, make, give birth to, bear fruit, cause to grow
crudelis, crudelis, crudele (adj.)	cruel, hardhearted, bloodthirsty, harsh
cubiculum, cubiculi N.	bedroom
cubliculum	bedroom
culīna	kitchen
culina, culinae F.	kitchen
culpa, culpae F.	blame, fault
culpo, culpare, culpavi, culpatus	to blame, censure
cum	with
cum (prep.) + (ablative)	with
cum (prep.) + (ablative)	with
cum (prep)	with
cupiditas, cupiditatis F.	desire, longing, passion, avarice
cupio, cupere, cupivi, cupitus	to desire, wish for, covet, favor
cupit	he/she wants
cupīvit	perfect - he/she wanted
cur	why
cūr	why
cur (adv)	why
cura, curae F.	care
cura, curae F.	care, attention, caution, anxiety
curo, curare, curavi, curatus	to look after, provide for, care about, cure
currit	he/she runs
curro, currere, cucurri, cursus	to run, rush, move quickly
curro, currere, cucurri, cursus	to run, to hurry
custodio, custodire, custodivi, custoditus	to guard, protect, watch over, keep safe
custōdit	he/she guards
custōdīvit	perfect - he/she guarded
custōs, custōdem	guard
custos, custodis M/F	guard, sentry, guardian, doorkeeper, warden
dat	he/she gives
dē	down; about
de (prep.) + (ablative)	down from, from, off, about, concerning
de (prep.) + ablative	down from, from, concerning, about
dea, deae F	goddess
dea, deae F.	goddess
dea, deae F.	goddess
debeo, debere, debui, debitum	to owe, ought, must, should
debeo, debere, debui, debitus	to owe, be indebted to, ought, must
decet (impersonal verb)	it is fitting, right, proper
dēcidere, dēcidī	perfect - he/she fell down
dēcidō	he/she falls down
decido, decidere, decidi, -	to fall, drop, hang, sink, die
decipio, decipere, decepi, deceptus	to deceive, trick
decōrus	right, proper
decorus, decora, decorum (adj.)	right, proper
dedit	perfect - he/she gave
defendo, defendere, defendi, defensum	to ward off, defend, protect
dehinc (adv.)	then, next
deicio, deicere, deieci, deiectus	to throw down, overthrow, destroy, kill
deinde	then
deinde (adv)	thereupon, next, then
delectatio, delectationis F	delight, pleasure, enjoyment
delectatio, delectationis F.	delight, pleasure, enjoyment
delecto, delectare, delectavi, delectatus	to delight, charm, please
delecto, delectare, delectavi, delectatus	to delight, please, amuse, charm
dēleō	he/she destroys
deleo, delere, delevi, deletus	erase, destroy, delete, wipe out, remove
dēlēre, dēlēvī	perfect - he/she destroyed
demonstro, demonstrare, demonstravi, demonstratus	to point out, show, reveal
demonstro, demonstraree, demonstravi, demonstratus	to point out, show, demonstrate
denique (adv.)	at last, finally
dēnsus	thick
densus, densa, densum (adj.)	thick, dense, solid
depono, deponere, deposui, depositus	to put down, lay aside, give up, resign, deposit, entrust
derideo, deridere, derisi, derisus	to mock, laugh at, make fun of
descendo, descendere, descendi, descensus	to go down, come down
desero, deserere, deserui, desertus	to desert
desino, desinere, desivi, desitus	to stop, end, finish, cease, desist
despero, desperare, desperavi, desperatus	to despair, have no hope for
deus	God
deus, dei M.	god
deus, dei M.	god
dexter, dextra, dextrum (adj.)	right, right-handed
dīcere, dīxī	perfect - he/she said
dīcō	he/she say
dico, dicere, dixi, dictus	to say, declare, state, assert, talk
dico, dicere, dixi, dictus	to say, tell, speak, call, name
diēs	day
diēs nātālis	birthday
dies, diei M.	day
dies, diei, M.	day
difficilis	difficult
difficilis, difficilis, difficile (adj.)	difficult, hard, troublesome
difficilis, difficilis, difficile (adj.)	hard, difficult, troublesome
dignitas, dignitatis F.	importance, prestige, rank, worth, standing, esteem
diligens, diligens, diligens (genitive diligentis) (adj.)	diligent, careful
diligens, diligens, diligentis (adj.)	diligent, careful
dīligenter	carefully
diligenter (adv.)	carefully
diligentia, diligentiae F.	industry, diligence, care, hard work
diligo, diligere, dilexi, dilectus	to esteem, love
dimitto, dimittere, dimisi, dimissus	to send away, let go, dismiss
dirus, dira, dirum (adj.)	dreadful, awful
discedo, discedere, discessi, discessum	to go away, depart
discedo, discedere, discessi, discessus	to depart, leave, withdraw, scatter
discipulus, discipuli M.
discipula, discupulae F.	student
disco, discere, didici, discitus	to learn, hear, get to know, become acquainted with
dissentio, dissentire, dissensi, dissensus	to disagree, dissent, differ
dissimilis, dissimilis, dissimile (adj.)	unlike, different
diu (adv.)	for a long time
diu (adv.)	long, for a long time
divitiae, divitiarum F. (plural)	riches, wealth
do, dare, dedi, datum	to give, offer
do, dare, dedi, datus	to give, allow, permit, offer,
doceo,docere, docui, doctus	to teach
doctus, docta, doctum (adj.)	learned, clever
doctus, docta, doctum (adj.)	taught, learned, skilled
domina	mistress
domina, dominae F.	lady, mistress
dominus	master
dominus, domini M.	master, lord
domus, domus f.	home
dōnum	present, gift
donum, doni N.	gift, present
donum, doni N.	present, gift
dormit	he/she sleeps
dormo, dormire, dormivi, dormitus	to sleep
dūcit	he/she leads
duco, ducere, duxi, ductus	to lead, command, think, consider
dulcis, dulcis, dulce	sweet, pleasant, charming
dulcis, dulcis, dulce (adj.)	sweet, pleasant, agreeable
dum (conj.)	while, as long as, at the same time that, until
duo	two
duo, duae, duo (adj.)	two
durus, dura, durum (adj.)	harsh, hard
dux, ducis M.	leader, guide, commander, general
dūxit	perfect - he/she led
ē, ex	out of, from
e, ex	out of, from, because of
ecce!	see! look!
ecce! (interjection)	see! look!
educo, educare, educavi, educatum	to bring up, educate
efficio, efficere, effeci, effectus	to carry out, accomplish
effigies, effigiis F.	image, copy, likeness, portrait, effigy, statue
effugio, effugere, effugi, effugitus	to flee, to avoid, to slip away from
ego	I
ego (pronoun)	I
ego (pronoun)	I
egressus, egressa, egressum	having gone out
ēheu	alas! oh dear!
eheu! (interjection)	alas! oh dear!
eligo, eligere, elegi, electus	to choose, select, pick out
ēmīsit	perfect - he/she throws, sends out
emit	he/she buys
ēmittit	he/she throws, sends out
emitto, emittere, emisi, emissus	to send out, let go
emo, emere, emi, emptus	to buy, to obtain
enim (conj.)	for
enim (conj.)	for, in fact, truly
eo, ire, ii, itus	to go, march, advance
epistula	letter
epistula, epistulae F.	letter, epistle
eques, equitis M.	horseman, knight
equus, equi M.	horse
equus, equi M.	horse
erat	was
eripio, eripere, eripui, ereptum	to snatch away, to take away, to rescue
erro, errare, erravi, erratus	to make a mistake, to err, to wonder
erro, errare, erravi, erratus	to wander, err, go astray, make a mistake
esse, fuī	perfect - was
est	is
et	and
et (conj.)	and
etiam	and also, besides, in addition, as well, still, even now
etiam (adv.)	even, also
euge	hurrah
euge! (interjection)	hurrah!
eum	him
ex (prep.) + (ablative)	out of, from, from within, by reason of, on account of, of
exanimatus, exanimata, exanimatum (adj.)	unconscious
excipio, excipere, excepi, exceptus	to take out, except, take, receive, capture
excitāre, excitāvī	perfect - he/she aroused, woke up
excitō	he/she arouses, wakes up
excito, excitare, excitavi, excitatus	to arouse, wake up, incite, excite
exclāmat	he/she exclaims
exclāmāvit	perfect - he/she exclaimed
exclamo, exclamare, exclamavi, exclamatus	to exclaim, shout, cry out, call out
exeo, exire, exii, exitus	to go out, exit
exerceo, exercere, exercui, exercitus	to exercise, work at, keep busy, oversee, drive on
exercet	he/she exercises
exercuit	perfect - he/she exercised
exit	he/she goes out
exitium, exitii N.	destruction, ruin
exitium, exitii, N.	ruin, destrucition
expello, expellere, expuli, expulsus	to drive out, expel, banish
explico, explicare, explicavi, explicatus	to explain, unfold, extend, set forth
exspectat	he/she waits for
exspecto, exspectare, exspectavi, exspectatus	to look for, expect, await
exspecto, exspectare, exspectavi, exspectatus	to wait for, exspect
extra (prep) + (accusative)	outside of, beyond, without, beside, except
extraho, extrahere, extraxi, extractus	to drag out, pull out, extract
faber, fabri M.	craftsman, artisan, workman
fābula	play, story
fabula, fabulae F.	play, story
fabula, fabulae F.	story, tale, play
facile	easily
facile (adv.)	easily
facilis, facilis, facile (adj.)	easy
facilis, facilis, facile (adj.)	easy, agreeable
facio, facere, feci, factus	to make, do
facio, facere, feci, factus	to make, do, accomplish
facit	he/she makes, does
factum, facti N.	deed, act, achievement
fama, famae F.	rumor, report, fame, reputation
familia, familiae F.	household, family
familiaris, familiaris M/F	relative, relation, family member
familiāris; familiārem	relative; relation
faveo, favere, favi, fautus	to favor, befriend, support, back up
fāvet	favors; supports
fāvit	dative - to favor; to support
fax, facis F	torch, fire, flame (of love), torment
fēcit	Perfect - he/she made, did
felix, felicis (adj.)	lucky, fortunate, happy
fēmina	woman
femina, feminae F.	woman
femina, feminae F.	woman
fenestra, fenestrae, F.	window
fero, ferre, tuli, latus	to bring, carry, bear, speak of
ferōciter	fiercely
ferociter (adv.)	fiercely
ferōx	fierce
ferox, ferocis (adj.)	bold, fierce, ferocious
ferox, ferocis (adj.)	fierce, savage
ferrum ,ferri, N.	iron, sword
fert	he/she brings, carries
fessus	tired
fessus, fessa, fessum (adj.)	tired, wearied, worn out, exhausted
festīnat	he/she hurries
festino, festinare, festinavi, festinatus	to hurry, hasten
fidēlis	faithful, loyal
fidelis, fidelis, fidele (adj.)	faithful, loyal
fidelis, fidelis, fidele (adj.)	faithful, loyal, devoted, dependable
fides, fidei, F.	faith, trust, fidelity
filia, filiae F.	daughter
filia, filiae F.	daughter
(dative and ablative plural = filiabus)
fīlius	son
filius, filii M.	son
filius, filii M.	son
finis, finis, m.	end, limit, boundary
flamma	flame
flamma, flammae F.	flame, blaze, ardor
flos, floris M.	flower, blossom
flumen, fluminis N	river
flumen, fluminis N.	river
fluo, fluere, fluxi, fluctus	flow
fluo, fluere, fluxi, fluxum	to flow
fons, fontis, M.	fountain, spring
forma, formae F.	form, shape, beauty
fortasse (adv.)	perhaps, possibly
forte	by chance
fortis	brave, strong
fortis, fortis (adj.)	brave, strong
fortis, fortis, forte (adj.)	strong, brave
fortiter	bravely
fortiter (adv.)	bravely, strongly, boldly
fortuna, fortunae F.	fortune, luck
fortunatus, fortunata, fortunatum (adj.)	lucky, fortunate, happy
forum	forum, marketplace
forum, fori N.	forum, business center
fractus, fracta, fractum (adj.)	broken, shattered, crushed
frango, frangere, fregi, fractus	to break, shatter, crush, subdue
frāter	brother
frater, fratris M.	brother
frater, fratris M.	brother
fructus, fructus m.	fruit, profit, benefit, enjoyment
frūstrā	in vain
frustra (adv.)	in vain
fugio, fugere, fugi, fugitus	flee, fly, run away, avoid, shun
fugio, fugere, fugi, fugitus	to flee, fly, run away, escape, avoid, shun
fūgit	runs away, flees; perfect - ran away, fled
fundo, fundere, fudi, fusus	to pour
fundus	farm
fundus, fundi M.	farm, estate
fūr	thief
fur, furis M.	thief, robber
furens, furens, furens (genitive = furentis) (adj.)	furious, in a rage, wild
gaudeo, gaudere, gavisus sum	to be glad, rejoice
gaudeo, gaudere, gavisus sum (semideponent)	to be glad, rejoice
geminus, gemina, geminum (adj.)	twin
gēns	family
gens, gentis F.	family,tribe, clan, nation, people
gens, gentis, F.	clan, race, nation, people, tribe
genu, genus n.	knee
genus, generis N	origin, kind, type, sort, class
gero, gerere, gessi, gestus	to carry, carry on, manage, conduct/wage, wear, perform
gero, gerere, gessi, gestus	to wear
gladius	sword
gladius, gladii M.	sword
gloria, gloriae F.	glory, fame
gracilis, gracilis, gracile (adj.)	slender
gracilis, gracilis, gracile (adj.)	slender, thin
Graecia, Graeciae F.	Greece
Graecus, Graeca, Graecum (adj.)	Greek
Graecus, Graeci M.	a Greek
gratias ago	to give thanks
gravis, gravis, grave (adj.)	heavy, serious
gravis, gravis, grave (adj.)	heavy, weighty, serious, important
graviter (adv.)	seriously
gustat	he/she tastes
gusto, gustare, gustavi, gustatus	to taste
habeo, habere, habui, habitus	to have, hold, consider, think, reason, manage, keep
habeo, habere, habui, habitus	to have, hold, possess, consider, regard
habet	he/she has
habitat	he/she lives
habitāvit	perfect - he/she lived
habito, habitare, habitavi, habitatus	to live, reside
haereo, haerere, haesi, haesus	to stick, cling
haesito, haesitare, haesitavi, haesitatus	to hesitate
haruspex, haruspicis, M.	diviner, soothsayer
hasta, hastae F.	spear
hasta, hastae F.	spear
heri	yesterday
heri (adv.)	yesterday
heri (adv.)	yesterday
hic	this
hic (adv.)	here
hic, haec, hoc (pronoun)	this, the latter
hic, haec, hoc (pronoun)	this, these
hodiē	today
hodie (adv.)	today
hodie (adv.)	today
homo, hominis M.	man, human being
homo, hominis M.	person, man
homō; hominem	person, man
honor, honoris M.	honor, duty
hora, horae F.	hour, time
hora, horae, F.	hour
horreum	barn, granary
horreum, horrei N.	storehouse, barn, granary
hortus	garden
hortus, horti M.	garden
hospes, hospitis M.	host, guest, visitor, stranger
hospes; hospitem	guest or host
hostis, hostis M	an enemy
hostis, hostis, M.	enemy
huc (adv.)	here, to this place, to this point
humanus, humana, humanum (adj.)	human, humane, kind, refined, cultivated
humi	on the ground
humilis, humilis, humile (adj.)	lowly, humble
humilis, humilis, humile (adj.)	lowly, humble
iaceo, iacere, iacui, iacitus	to lie
iaceo, iacere, iacui, iacitus	to lie, lie down
iacet	he/she lies
iacio, iacere, ieci, iactus	to throw, cast
iacio, iacere, ieci, iactus	to throw, hurl
iacto, iactare, iactavi, iactatus	to throw, cast
iacuit	perfect - he/she lied
iam	now
iam (adv.)	now, already, even now
iam (adv.)	now, already, soon
iānua	door
ianua, ianuae F.	door, gate
ibi (adv.)	there
ibi (adv.)	there, in that place
idem, eadem, idem (pronoun)	the same
igitur	therefore
igitur (conj.)	therefore, consequently
igitur (conj.)	therefore, so, then, consequently
ignarus, ignara, ignarum (adj.)	not knowing, unaware, ignorant, senseless
ignāvus	cowardly, lazy
ignavus, ignava, ignavum (adj.)	cowardly, lazy
ignis, ignis, M.	fire
iit	perfect - he/she went
ille	that
ille, illa, illud (pronoun)	that, those
illuc	there, to that place
immemor, immemor, immemor (genitive = immemoris) (adj.)	forgetful, heedless
immortalis, immortalis, immortale	immortal
immortalis, immortalis, immortale (adj.)	immortal (di immortales = heavens above)
immotus, immota, immotum (adj.)	still, motionless
impedio, impedire, impedivi, impeditus	to hinder, impede, obstruct
imperator, imperatoris M.	emperor, ruler, commander
imperator, imperatoris M.	general, commander, emperor
imperium	empire
imperium, imperii N	power to command, authority, command, control
imperium, imperii N.	empire, authority, command, rule
impero, imperaro, imperavi, imperatus + (dative)	to order, command, levy, rule
impetus, impetus, M.	attack
in	in, on
in (prep.) + (ablative)	in, on
in (prep.) + (accusative)	into, onto, toward, against
in (prep)	in, on, into, onto
incendo, incendere, incendi, incensus	to set fire to, kindle, burn, rouse, excite, incense
incertus, incerta, incertum (adj.)	uncertain, unsure, doubtful
incidit	falls; perfect - fell
incido, incidere, incidi, incasus	happen, fall into, fall in with, meet
incipio, incipere, incepi, inceptus	to begin
incitat	he/she urges on
incitāvit	perfect - he/she urged on
incito, incitare, incitavi, incitatus	to urge on, encourage, incite
īnfāns	baby, child
infans, infantis M/F	baby, child, infant
infelix, infelix, infelix (adj.) (gen. infelicis)	unlucky
infero, inferre, intuli, inlatus	to bring in, bring on
infestus, infesta, infestum (adj.)	hostile
ingēns	huge
ingens, ingentis (adj.)	huge
ingens, ingentis (adj.)	large, big, huge
ingressus, ingressa, ingressum (adj.)	having entered
inicio, inicere, inieci, iniectus	to throw in
inimīcus	enemy
inimicus, inimici M.	enemy
inquit	he/she says
inquit	says
inquit (defective verb)	he/she says/said
insidia, insidiae F	plot, treachery, snare, ambush (plural)
insidiae, insidiarum F (pl.)	ambush, plot, treachery
īnspexit	perfect - he/she looked at, inspected, examined
inspicio, inspicere, inspexi, inspectus	to look at, inspect, examine
īnspicit	he/she looks at, inspects, examines
insula, insulae F.	island
insula, insulae F.	island, apartment
intellegit	he/she understands
intellego, intellegere, intellexi, intellectus	to understand, realize
intellēxit	perfect - he/she understood
intelligo, intelligere, - , -	to understand, realize
intentē	intently
intente (adv.)	intently
inter (prep.) + (accusative)	between, among
inter (prep.) + (accusative)	between, among, during
interea (adv.)	meanwhile
interficere, interfēcī	perfect - he/she killed
interficiō	he/she kill
interficio, interficere, interfeci, interfectus	to kill, destroy
intrat	he/she enters
intro, intrare, intravi, intratus	to enter
invenio, invenire, inveni, inventus	to come upon, find, discover, invent
invenit	he/she finds
invēnit	perfect - he/she found
invītat	he/she invites
invitāvit	perfect - he/she invited
invito, invitare, invitavi, invitatus	to invite, summon, encourage, entice
invitus	unwilling
invitus, invita, invitum (adj.)	unwilling
iocus, ioci M	joke
ipse, ipsa	himself, herself
ipse, ipsa, ipsum (pronoun)	himself, herself, itself
ipse, ipsa, ipsum (pronoun)	myself, yourself, himself, herself, itself
ira, irae F.	anger
īrātus	angry
iratus, irata, iratum (adj.)	angry
irrumpo, irrumpere, irrupi, irruptus	to burst in
is, ea, id (pronoun)	he, she, it
is, ea, id (pronoun)	he, she, it
iste	that
iste, ista, istud (pronoun)	that
iste, ista, istud (pronoun)	that, such
it	he/she goes
ita	in this way
ita vērō	yes
ita vero (idiom)	yes, certainly
Italia, Italiae F.	Italy
itaque (adv.)	and so, therefore
itaque (conj.)	and so, therefore
iter, itineris N.	journey, road, passage
iterum	again
iterum (adv.)	again, a second time
iterum (adv.)	again, a second time, for the second time
iubeo, iubere, iussi, iussus	to order, command
iucundus, iucunda, iucundum (adj.)	pleasant, delightful, agreeable, pleasing
iūdex	judge
iudex, iudicis M.	judge
iudex, iudicis M.	judge, juror
iudicium, iudicii N.	judgment, decision, opinion, trial
iungo, iungere, iunxi, iunctus	to join
ius, iuris N.	right, justice, law
iussum, iussi N	order, command, decree, law
iuvenis	young man
iuvenis, iuvenis M/F	youth, young man, young woman
iuvo, iuvare, iuvi, iutus	to help, aid, assist
labor, laboris M.	work, labor, toil
labōrat	he/she works, is working
laboro, laborare, laboravi, laboratum	to labor, be in distress
laboro, laborare, laboravi, laboratus	to work
lacrima, lacrimae, F.	tear
lacrimat	he/she cries, weeps
lacrimāvit	perfect - he/she cried, weeped
lacrimo, lacrimare, lacrimavi, lacrimatus	to weep, cry
laedo, laedere, laesi, laesus	to harm, strike, wound, harm, offend, annoy
laetus	happy
laetus, laeta, laetum (adj.)	happy
lateo, latere, latui, -	to lie hidden, lurk, escape notice
Latinus, Latina, Latinum (adj.)	Latin
latus, lata, latum (adj.)	wide, broad, spacious, extensive
laudat	he/she praises
laudo, laudare, laudavi, laudatus	to praise
laudo, laudare, laudavi, laudatus	to praise
laus, laudis F.	praise, glory, fame
lavāre, lāvī	perfect - he/she washed
lavō	he/she washes
lavo, lavare, lavi, lotus	to wash, bathe, soak
lectus, lecti M.	bed, couch, lounge, sofa
legit	he/she reads or read
lego, legere, legi, lectum	to pick out, choose, read
lego, legere, legi, lectus	to read, collect, pick out
lente (adv.)	slowly
leō	lion
leo, leonis M.	lion
libenter (adv.)	gladly
liber	book
liber, libera, liberum (adj.)	free
liber, libri	book
liber, libri M.	book
līberālis	generous
liberalis, liberalis, liberale (adj.)	generous, honorable, courteous, liberal
libero, liberare, liberavi, liberatus	to free, liberate
libero, liberare, liberavi, liberatus	to free, set free
libertas, libertatis F.	liberty, freedom
lībertus	freedman, ex-slave
libertus, liberti M.	freedman, ex-slave
lingua, linguae F.	tongue, language
littera, litterae F.	letter (of the alphabet)
litterae, litterarum F.	letter, epistle
litus, litoris N.	shore, coast
litus, litoris N.	shore, seashore, coast, beach
locus, loci M.	place, passage (in literature)
locus, loci M.	place, position, post
longus, longa, longum (adj.)	long
ludus, ludi M	game, sport, school
luna, lunae f.	moon
magis (adv.)	more, rather
magister, magistri M.	teacher, master
magistra, magistrae F.	teacher, mistress
magnanimus, magnanima, magnanimum	great-hearted, brave, magnanimous
magnopere (adv.)	greatly
magnus	large
magnus, magna, magnum (adj.)	big, large, great
magnus, magna, magnum (adj.)	large, great, important
maior, maior, maios (comparative adj.)	greater, older
maior, maius (comparative adj.)	greater, older
maiores, maiorum M (plural)	ancestors
maiores, maiorum M. pl	ancestors
malus, mala, malum (adj.)	bad, wicked, evil
mandatum, mandati N.	instruction, order
mane	in the morning
maneo, manere, mansi, mansus	to remain, stay, wait for
maneo, manere, mansi, mansus	to remain, to stay, to continue
manet	he/she remains, stays
mānsit	perfect - he/she remained, stayed
manus, manus F	hand, fist, gang, team, band of soldiers
manus, manus F	hand, fist, team, gang, band of soldiers
manus, manus f.	hand, band, troop, gang
mare, maris N.	sea
mare, maris N.	sea
marītus	husband
maritus, mariti M.	husband, lover
māter	mother
mater, matris F.	mother
mater, matris F.	mother
maxime (adv.)	very greatly, most of
maximus, maxima, maximum (adj.)	very big, very large, very great
me (pronoun)	I, me, myself
medica, medicae F.	doctor, physician
medicus, medici M.	doctor, physician
medius	middle
medius, media, medium (adj.)	middle
medius, media, medium (adj.)	middle, ordinary, common
melior, melior, melius (adj.)	better
memoria, memoriae F.	memory, recollection
mendāx	liar
mendax, mendacis (adj.) M/F/N	lying, false, deceitful, counterfeit
(substantive = liar)
mens, mentis F.	mind, thought, intention
mēnsa	table
mensa, mensae F.	table
mercātor	merchant
mercator, mercatoris M.	merchant
metus, metus m.	fear, dread, anxiety
meus	my, mine
meus, mea, meum (adj.)	my
meus, mea, meum (adj.)	my, mine
miles, militia M	soldier
miles, militis M.	soldier
mille (indeclinable) (adj.)	thousand
minimē	no
minime (adv.)	no, not at all
minimus, minima, minimum (adj.)	very little, least
mīrābilis	marvelous, strange
mirabilis, mirabilis, mirabile (adj.)	wonderful, marvelous, astonishing, strange
misceo, miscere, miscui, mixtum	to mix, stir up, disturb
miser, misera, miserum (adj.)	poor, miserable, wretched, unhappy
mīsit	perfect - he/she sent
mittit	he/she sends
mitto, mittere, misi, missus	to send, let go
mitto, mittere, misi, missus	to send, throw, hurl, cast, let out, dismiss, release
modus, modi M.	manner, way, kind
modus, modi, M.	measure, bound, limit, manner, way
molestus, molesta, molestum (adj.)	troublesome
moneo, monere, monui, monitus	to remind, advise, warn
moneo, monere, monui, monitus	to warn, advise, remind
mons, montis m.	mountain
mons, montis M.	mountain
mōns; montem	mountain
mora, morae F.	delay
morbus, morbi M.	disease, sickness
morbus, morbi, M.	illness
mors, mortis	death
mors, mortis F.	death
mortalis, mortalis, mortale (adj.)	mortal
mortuus	dead
mortuus, mortua, mortuum (adj.)	dead
mos, moris M.	custom, manner, habit
moveo, movere, movi, motum	to move, arouse, affect
mox	soon
mox (adv.)	soon
multī	many
multitudo, multitudinis F.	crowd, multitude, mob
multus	much
multus, multa, multum (adj.)	much, many
multus, multa, multum (adj.)	much, many
mundus, mundi, M.	world, universe
mūrus	wall
murus, muri M.	wall
muto, mutare, mutavi, mutatus	to change, alter, exchange
nam (conj.)	for
nam (conj.)	for, on the other hand, for instance
nārrat	he/she tells, relates
nārrāvit	perfect - he/she told, related
narro, narrare, narravi, narratus	to tell, narrate, relate, describe
narro, narrare, narravi, narratus	to tell, report, narrate
natura, naturae F.	nature
nauta, nautae M.	sailor
nauta, nautae M.	sailor
navigo, navigare, navigavi, navigatus	to sail, navigate
nāvis	ship
navis, navis F.	ship
navis, navis, F.	ship, boat
necat	he/she kills
necāvit	perfect - he/she killed
necesse	necessary
necesse (undeclineable adj.)	necessary, essential, unavoidable, inevitable
neco, necare, necavi, necatus	to kill, put to death, murder
neglegens, neglegens, neglegens, gen. neglegentis	careless, unconcerned, indifferent
nego, negare, negavi, negatum	to deny, say that... not
negotium, negotii N.	business (w/ ago: to do business)
nemo M/F	no one, nobody
nemo, neminis M/F	no one, nobody
nepos, nepotis M	grandson, descendant
nepos, nepotis M.	grandson, descendant
neque, nec (conj.)	and not, nor
neque...neque	neither...nor
nescio, nescire, nescivi, nescitus	to not know, be unaware/ignorant of/unfamiliar with
neuter, neutra, neutrum (adj.)	not either, neither
nihil	nothing
nihil (indecl.) N.	nothing
nihil (indecl.) N.	nothing
nihil (undeclined)	nothing
nimium (adv.)	too, too much, excessively
nimium, nimii N.	too much
nobilis, nobilis, nobile (adj.)	noble, well born, aristocratic, important
nōbilis; nōbilem	noble
noceo, nocere, nocui, nocitus	+ (dative) harm, hurt, injure
nōlle, nōluī	perfect - he/she did not want
nōlō	he/she does not want
nolo, nolle, nolui, -	to not want, be unwilling, refuse to
nomen, nominis N.	name, family name, noun, title
nomen, nominis N.	name, noun
nōn	not
non (adv.)	not
non (adv.)	not
nonne (interrogative expecting a 'yes' answer)	surely?
nonnulli, nonnullae, nonnulla (always plural) (adj.)	some, several
nōs	we
nos (pronoun)	we, us
noster	our
noster, nostra, nostrum (adj.)	our
noster, nostra, nostrum (adj.)	our, ours
nōtus	well-known, famous
notus, nota, notum (adj.)	well-known, famous
novi, novisse, notus, -	to know
novus	new
novus, nova, novum (adj.)	new, strange
novus, nova, novum (adj.)	new, young, fresh
nox, noctis F	night
nubes, nubis F.	cloud
nubes, nubis F.	cloud, mist, smoke, haze
nūbēs; nūbem	cloud
nūllus	not any, no
nullus, nulla, nullum (adj.)	not any, no, none
nullus, nulla, nullum (adj.)	not any, none
num	surely not, if, whether (asks a question expecting a negative answer)
num?	surely you are not?
numberō	he/she counts
numerāre, numberāvī	perfect - he/she counted
numero, numerare, numeravi, numeratus	to count
numerus, numeri M.	number
numquam (adv.)	never
numquam (adv.)	never
nunc	now
nunc (adv.)	now
nunc (adv.)	now
nūntiat	he/she announces
nūntiāvit	perfect - he/she announced
nuntio, nuntiare, nuntiavi, nuntiatus	to announce, report
nuntio, nuntiare, nuntiavi, nuntiatus	to announce, report, relate
nūntius	messenger
nuntius, nuntii M.	messenger
nuper (adv.)	recently
nusquam (adv.)	nowhere
O! (interjection)	O! Oh!
obsto, obstare, obstiti, obstitus + (dative)	to oppose, resist, block, stand in the way
obtulit	perfect - he/she offered
occupatus, occupata, occupatum (adj.)	busy
occuro, occurrere, occurri + (dative)	occur, come about, happen
oculus, oculi m.	eye
oculus, oculi M.	eye
odi, odisse, osum (defective verb) (perfect form, present meaning)	to hate
offero, offerre, obtuli, oblatus	to offer, hand over, present
offert	he/she offers
officium, officii N.	duty, service
oleum	oil
ōlim	once upon a time
olim (adv.)	once, once upon a time, long ago, formerly, some day, in the future
olim (adv.)	once, some time ago
omnis	all
omnis, omnis, omne (adj.)	all, each, every
omnis, omnis, omne (adj.)	every, all
oppidum, oppidi, N.	town
opprimo, opprimere, oppressi, oppressum	to suppress, overwhelm, overpower, check
oppugno, oppugnare, oppugnavi, oppugnatus	to attack
optimē	very well
optimus	very good, excellent, best
optimus, optima, optimum (adj.)	very good, excellent, best
orator, oratoris M.	orator, speaker
ōrdō, ōrdinem	row
ordo, ordinis M.	row, order, rank, series
orno, ornare, ornavi, ornatus	to decorate
os, oris N.	face, mouth, speech, expression
os, oris N.	mouth, face
osculum, osculi N	kiss
ostendit	shows
ostendo, ostendere, ostendi, -	to show, reveal, make clear, point out
ostendo, ostendere, ostendi, ostentum	to exhibit, show, display
otium, otii N.	leisure, peace
paene	nearly, almost
paene (adv.)	hardly, nearly, almost
parat	he/she prepares
paratus, parata, paratum (adj.)	prepared, ready, equipped, provided
parāvit	perfect - he/she prepared
parco, parcere, peperci, parsus	to spare, refrain from
pareo, parere, parui, paritus (+ Dative)	to obey
paro, parare, paravi, paratus	to prepare, plan
paro, parare, paravi, paratus	to prepare, provide, obtain
pars, partis F	part, region, share, portion
pars, partis F.	part, share
parvus	small, little
parvus, parva, parvum (adj.)	small, little
parvus, parva, parvum (adj.)	small, little
passus, passa, passum (adj.)	having suffered
patefacio, patefacere, patefeci, patefactus	to make open, open, disclose, expose
patefacio, patefacere, patefeci, patefactus	to reveal
pater	father
pater, patris M.	father
pater, patris M.	father
patientia, patientiae F.	suffering, patience, endurance
patria, patriae F.	fatherland, native land, country
pauci, paucae, pauca (adj. - always plural)	few, a few
pauci, paucae, pauca (adj.)	few, a few
paulīsper	for a short time
paulisper (adv.)	for a short time
pāx	peace
pax, pacis F.	peace
pax, pacis F.	peace
pecūnia	money
pecunia, pecuniae F.	money
pecunia, pecuniae F.	money
pello, pellere, pepuli, pulsum	to strike, push, drive out, banish
per	through
per (prep.)	through, during, by means of
pereo, perire, perii, peritus	to die, perish, pass away, be destroyed
perfidus, perfida, perfidum (adj.)	treacherous, untrustworthy
perfugium, perfugii N.	refuge, shelter
periculum, periculi N.	danger, peril, risk
periculum, periculi N.	danger, risk
peritus, perita, peritum (adj.)	skillful, experienced
perpetuus, perpetua, perpetuum (adj.)	perpetual, continuous
persuadeo, persuadere, persuasi, persuatus	to persuade
perterritus	terrified
perterritus, perterrita, perterritum (adj.)	terrified
pervenio, pervenire, perveni, perventus	to come to, reach, arrive
pēs	foot, paw
pes, pedis M.	foot
pessimus, pessima, pessimum (adj.)	very bad, worst
pestis	pest, rascal
pestis, pestis F.	pest, plague, destruction
petit	he/she heads for, attacks, seeks
peto, petere, petivi, petitum	to seek, aim at, beg, beseech
peto, petere, petivi, petitus	beg, ask for, attack, aim at, desire
peto, petere, petivi, petitus	to head for, attack, seek, ask for
philosophia, philosophiae F.	philosophy
placeo, placere, placui, placitus	to please, satisfy, give pleasure to
placet	it pleases
placuit	dative - it pleased
plaudit	he/she applauds, claps
plaudo, plaudere, plausi, plausus	to applaud, clap, pat
plaustrum, plaustri N.	wagon, cart
plenus, plena, plenum (adj.)	full
plenus, plena, plenum (adj.)	full, abundant, generous
plurimi, plurimae, plurima	very many
plurimus, plurima, plurimum	very much
plus, pluris, N.	more
pōculum	cup
poculum, poculi N.	cup, drink
poena, poenae F.	penalty, punishment
(poenas dare = to pay the penalty)
poena, poenae F.	punishment (poenas dare = to pay the price, be punished)
poēta	poet
poeta, poetae M.	poet
poeta, poetae M.	poet
pono, ponere, posui, positum	to put
pono, ponere, posui, positum	to put, place, set
pono, ponere, posui, positus	to place, put, set, situate
pons, pontis M.	bridge
populus, populi M.	the people, a people, a nation
porta	gate
porta, portae F.	gate, door, entrance
porta, portae F.	gate, entrance
portat	he/she carries
porto, portare, portavi, portatus	to carry
portus	harbor
portus, portus M.	port, harbor, refuge, haven
posco, poscere, poposci	to demand, ask for
posse, potui	perfect - he/she could
possum	he/she can
possum, posse, potui	to be able, can, have power
possum, posse, potui, -	to be able, can
post	after
post (adv.)	behind, afterwards, after
post (prep.) + (accusative)	behind, after
post (prep) + (accusative)	behind, after
postea (adv.)	afterwards
postea (adv.)	afterwards
postquam	afterwards
postquam (conj.)	after, when
postremo (adv.)	at last, finally
postridie	on the following/next day
postulat	he/she demands
postulāvit	perfect - he/she demanded
postulo, postulare, postulavi, postulatus	to demand, claim, ask for, require
potens, potentis (adj.)	able, powerful, mighty, strong
potens, potentis (adj.)	powerful
praeceps, praeceps, praeceps, (genitive praecipitis)	(adj.) headlong, head first
praemium, praemii N	prize, reward, gift, recompense
praesidium, praesidii N	protection, help, guard, garrison
praesum, praeesse, praefui, praefuturus + (dative)	to be in charge of, be present
pravus, prava, pravum (adj.)	evil
precatus, precata, precatum	having prayed to
premo, premere, pressi, pressum	to press, press hard, pursue
pretium, pretii, N.	price
prex, precis	prayer
prīmus	first
primus, prima, primum (adj.)	first
primus, prima, primum (adj.)	first, foremost, chief, principal
primus, prima, primum (adj.)	first, foremost, chief, principal
princeps, principis M.	leader, chief
principium, principii N.	beginning
pro (prep.) + (ablative)	in front of, before, on behalf of, for the sake of, instead of, for
pro + (ablative)	in front of
probitas, probitatis F	uprightness, honest
probo, probare, probavi, probatum	to approve, recommend, test
probo, probare, probavi, probatum	to approve, recommend, test
prōcēdit	he/she advances, proceeds
procedo, procedere, processi, processus	to proceed, advance
prōcessit	perfect - he/she advanced, proceeded
prohibeo, prohibere, prohibui, prohibitum	to keep back, prevent, hinder, restrain, prohibit
prōmīsit	perfect - he/she promised
prōmittit	he/she promises
promitto, promittere, promisi, promissus	to promise
pronuntio, pronuntiare, pronuntiavi, pronuntiatum	to proclaim, announce, pronounce
prope	near
prope (prep.) + (accusative)	near
propter (prep) + accusative	on account of, because of
protinus (adv.)	immediately
proximus, proxima, proximum (adj.)	nearest, closest, next, most recent, immediate
prudentia, prudentiae, F.	prudence, good sense
puella	girl
puella, puellae F.	girl
puella, puellae F.	girl
puer	boy
puer, pueri M.	boy
puer, pueri M.	boy; pl. = boys or children
pugilēs	boxers
pugna	fight
pugna, pugna F.	battle, fight
pugnat	he/she fights
pugnāvit	perfect - he/she fought
pugno, pugnare, pugnavi, pugnatus	to fight
pulcher	beautiful, handsome
pulcher, pulchra, pulchrum (adj.)	beautiful, handsome
pulcher, pulchra, pulchrum (adj.)	beautiful, handsome
pulsat	he/she hits, punches, whacks
pulso, pulsare, pulsavi, pulsatus	to hit, punch, beat, strike
punio, punire, punivi, punitus	to punish, avenge
puto, putare, putavi, putatus	to reckon, suppose, judge, think, imagine
quaerit	he/she searches for, looks for
quaero, quaerere, quaesivi, quaesitus	to search for, look for, seek, ask, inquire
quaero, quaerere, quaesivi, quaesitus	to seek, look for, search for
qualis, qualis, quale (adj.)	what sort of, what kind
quam	than, how
quam (adv.)	how
quam (adv.)	how, than
quam (adv.)	how, than, as (+superlative = as _ as possible)
quamquam	although
quamquam (conj.)	though, although, yet, nevertheless
quando (interrogative conj.)	when 
(si quando = if ever)
quantus, quanta, quantum (adj.)	how big, of such size
quare (adv.)	therefore, why
qui, quae, quod	who, that, which, what, of which kind
qui? quae? quod? (interrogative adj.)	what, which, what kind of
quid (pronoun)	what
quis	who
quis	who
quis? quid? (interrogative pronoun)	who, whose, whom, what, which
quisque, quidque (pronoun)	each one, each person, each thing
quisquis, quidquid	whoever, whatever
quo modo?	how
quo?	where, where to
quod	because
quod (conj.)	because
quod (conj.)	because, as far as
quondam (adv.)	formerly
quondam (adv.)	one day, once
quoniam (conj.)	since
quoque	also
quoque (adv.)	also, too
quot (indeclinable adj.)	how many, as many as
quot (indeclinable adj.)	how many, as many as
rapio, rapere, rapui, raptum	to seize, carry away, take
rapio, rapere, rapui, raptus	seize, grasp, pillage
rapit	he/she seizes; grabs
rapuit	perfect - he/she seized; grabbed
ratio, rationis F.	reckoning, account, reason, judgement, manner, method
recipio, recipere, recepi, receptus	to keep back, recover, take back, accept
recipio, recipere, recepi, receptus	to take back, regain, admit, receive
recumbit	he/she lies down, reclines
recumbo, recumbere, recubui, -	to recline, lie down
recumbuit	perfect - he/she lied down, reclined
recuso, recusare, recusavi, recusatus	to reject, refuse, object, decline
reddit	he/she gives back
reddo, reddere, reddidi, redditus	to give back, return, restore, hand over
redeo, redire, redii, reditus	to return, go back, pay back, respond
regina, reginae F.	queen
rego, regere, rexi, rectus	to rule, guide, direct
regressus, regressa, regressum (adj.)	having returned
reinēre, retunuī	perfect - he/she kept
relinquo, relinquere, reliqui, relictum	to leave behind, leave, abandon, desert
relinquo, relinquere, reliqui, relictus	to leave behind, abandon
remedium, remedii n.	cure, remedy
remedium, remedii N.	cure, remedy
rēs	thing
res huius modi (idiom)	a thing of this kind
res publica, rei publicae, F.	state, commonwealth, republic
res, rei F.	thing, event, business, fact
res, rei, F.	thing, matter, property, business, affair
resisto, resistere, restiti, -	to resist, pause, oppose, reply, withstand
respondeo, respondere, respondi, responsus	to reply, answer
respondet	he/she replies
retineō	he/she keeps
retineo, retinere, retinui, retentus	to hold back, restrain, uphold, delay, retain
revenio, revenire, reveni, reventus	to come back, return
revenit	he/she comes back, returns
revēnit	perfect - he/she came back, returned
rex, regis M.	king
rex, regis M.	king
rēx; rēgem	king
rideo, ridere, risi, risus	to laugh, laugh at
rideo, ridere, risi, risus	to laugh, smile
rīdet	he/she laughs, smiles
ripa, ripae F.	river bank
rogat	he/she asks
rogāvit	perfect - he/she asked
rogo, rogare, rogavi, rogatus	to ask, ask for
roma, romae F.	Rome
Romanus, Romana, Romanum (adj.)	Roman
rosa, rosae F.	rose
ruere, ruī	perfect - he/she rushed
ruō	he/she rushs
ruo, ruere, rui, rutus	to rush, run, charge, destroy, ruin
rursus (adv.)	turned back, backward, again, in turn, in return, on the contrary
sacer, sacra, sacrum (adj.)	sacred
sacerdos, sacerdotis M.	priest
sacerdos, sacerdotis M.	priest
saepe	often
saepe (adv.)	often
saepe (adv.)	often
saevio, saevire, saevii, saevitus	rage, rave, be angry
salus, salutis, F.	health, safety, greeting
salūtat	he/she greets
saluto, salutare, salutavi, salutatus	to greet
salvē	hello
salve, salvete	hello, greetings
salve!	hello!
salveo, salvere	to be well, be in good health
salvus, salva, salvum (adj.)	safe, sound
sanguis	blood
sanguis, sanguinis M.	blood, family
sanus, sana, sanum (adj.)	sound, healthy, sane
sapiens, sapiens, sapiens (adj.) (gen. sapientis)	wise
sapiens, sapientis (adj.)	wise, judicious
sapienta, sapientae F.	wisdom
satio, satiare, satiavi, satiatus	to satisfy, to sate
satis	enough
satis (adv.)	enough
satis (indecl. noun, adj., adv)	enough, sufficient(-ly)
satura, saturae F.	satire
saxum, saxi N.	stone
scelestus, scelesta, scelestum (adj.)	wicked, infamous, accursed
scelus, sceleris N.	evil deed, crime, sin, wickedness
scientia, scientiae F	knowledge
scio, scire, scivi, scitum	to know
scio, scire, scivi, scitus	to know
scrībit	he/she writes
scribo, scribere, scripsi, scriptus	to write, compose
scribo, scribere, scripsi, scriptus	to write,compose
scriptor, scriptoris M.	writer, author
sē	himself, herself, themselves
se (pronoun)	himself, herself, itself, themselves
secundus	second
secundus, secunda, secundum (adj.)	second
secundus, secunda, secundum (adj.)	second
sed	but
sed (conj.)	but
sedeo, sedere, sedi, sessus	to sit
sedet	sits
semper	always
semper (adv.)	always
semper (adv.)	always
senātor	senator
senator, senatoris M.	senator
senatus, senatus m.	senate
senectus, senectutis F.	old age
senex	old man
senex, senis (M.)	old, aged, old man
senex, senis M.	old man
sēnsit	perfect - he/she felt
sensus, sensus m.	feeling, sense
sententia	opinion
sententia, sententiae F.	feeling, thought, opinion, vote, sentence
sententia, sententiae F.	opinion, feeling, purpose
sentio, sentire, sensi, sensus	perceive, feel, sense, experience
sentio, sentire, sensi, sensus	to feel, perceive, think, experience
sentit	he/she feels
sermo, sermonis m.	conversation, discussion, rumor, speech
servat	he/she saves, protects
servāvit	perfect - he/she saved, protected
servitus, servitutis f.	servitude, slavery
servo, servare, servavi, servatus	to preserve, save, keep, guard
servo, servare, servavit, servatus	to save, protect, guard, preserve
servus	slave
servus, servi M	slave
servus, servi M.	slave
si (conj.)	if
sicut (conj.)	like, as, just like
signum	sign, signal
signum, signi	sign, seal, signal
signum, signi N.	sign, signal, indication, seal
silentium, silentii N	silence
silva	woods
silva, silvae F.	woods, forest
similis, similis, simile (adj.) + (genitive)	similar to, like, resembling
similis, similis, simile (adj.) + (genitive)	similar, like, resembling
simulac	as soon as
sine (prep.) + (ablative)	without
sine (prep.) + ablative case	without
sinister, sinistra, sinistrum (adj.)	left, left-handed; harmful, ill-omened
sol, solis M	sun
sol, solis M.	sun
solacium, solacii N.	comfort, relief
soleo, solere, solitus (semideponent)	to be accustomed to, usually, be in the habit of
sollicitus	worried; anxious
sollicitus, sollicita, sollicitum (adj.)	worried, anxious, concerned, troubled
sōlus	alone, lonely
solus, sola, solum (adj.)	alone, only, single, unique
solus, sola, solum (adj.)	alone, only, the only
sonitus, sonitus M.	sound, noise
soror, sororis F.	sister
spectāculum	show, spectacle
spectaculum, spectaculi N.	show, spectacle
spectat	he/she looks at, watches
specto, spectare, spectavi, spectatus	to look at, watch
spero, sperare, speravi, speratus	to hope for, hope that
spes, spei, F.	hope
spiritus, spiritus m.	breath, breathing, spirit, soul
stat	stands
statim	at once
statim (adv.)	immediately, at once
statio, stationis F.	post, station, watch
sto, stare, stavi, status	to stand
sto, stare, steti, status	to stand
strigilēs	scrapers
studium, studii N.	eagerness, zeal, pursuit, study
stultus	stupid
stultus, stulta, stultum (adj.)	foolish
stultus, stulta, stultum (adj.)	foolish, stupid
stultus, stulti M.	fool
suavis, suavis, suave	sweet, agreeable, pleasant, charming
sub (prep.) + (ablative)	beneath, under, below
sub + (ablative)	under, beneath, behind, at the foot of
sub + (accusative)	under, up to, up under, close to, until, before, about
subitō	suddenly
subito (adv.)	suddenly
sum	be
sum, esse, fui, futurus	to be
sum, esse, fui, futurus	to be
sum, esse, fui, futurus	to be, exist
sum, esse, fui, futurus	to be, exist
summus, summa, summum (adj.)	highest, the top of, greatest, the end of
superat	overcomes
superi, superorum M (pl.)	the gods
superi, superorum M. (plural)	the gods
supero, superare, superavi, superatus	to be above, overcome, surpass, conquer
supero, superare, superavi, superatus	to overcome, overpower, conquer, survive, surpass
supersum, superesse, superfui, superfuturus	to survive, be left over
superus, supera, superum (adj.)	above, upper
superus, supera, superum (adj.)	above, upper
surgit	he/she gets up
surgo, surgere, surrexi, surrectus	to get up, rise
suscipio, suscipere, suscepi, susceptum (sub+capio)	to undertake
suscipio, suscipere, suscepi, susceptus	to undertake, take on
suus	his
suus, sua, suum (adj.)	his, hers, its, their
suus, sua, suum (pronoun)	his own, her own, its own, their own
taberna	store
taberna, tabernae F.	store, shop, inn
tablīnum	study
tablinum, tablini N.	study
taceo, tacere, tacui, tacitus	to be silent
tacet	he/she silent, quiet
tacitē	quietly, silently
tacite (adv.)	quietly, silently
tacitus, tacita, tacitum (adj.)	silent, secret
tacuit	perfect - he/she was silent, was quiet
taedet (impersonal verb)	to be tired, weary, disgusted
talis, talis, tale (adj.)	such
tam (adv.)	so
tamen	however
tamen (adv.)	however, yet, nevertheless
tamen (adv.)	nevertheless, however, still
tamquam	as, like
tandem	at last
tandem (adv.)	finally, at last, in the end, eventually
tango, tangere, tetigi, tactum	to touch
tantum (adv.)	only
tantus, tanta, tantum (adj.)	so great, so much
tardus, tarda, tardum (adj.)	late
te (pronoun)	you
tempestas, tempestatis F.	period of time, season, weather, storm
templum	temple
templum, templi N.	temple, church
tempto, temptare, temptavi, temptatus	to attempt, try
tempus, temporis N.	time, occasion, opportunity
teneo, tenere, tenui, tenitus	to hold, keep, possess, support, preserve
teneo, tenere, tenui, tentus	to hold, keep, possess, restrain
tepidārium	warm room
terra	ground, land
terra, terrae F.	land, earth, ground, country
terra, terrea F.	land, earth, ground, country, region
terreo, terrere, terrui, territus	to frighten, scare, terrify
terreo, terrere, terrui, territus	to frighten, terrify
terret	he/she frightens
terruit	perfect - he/she frightened
tertius	third
tertius, tertia, tertium (adj.)	third
testis, testis M/F	witness
thermae	baths
timeo, timere, timui, -	to fear, be afraid of
timeo, timere, timui, -	to fear, dread, be afraid
timet	he/she fears, is afraid
timor, timoris M.	fear
timuit	perfect - he/she feared, was afraid
toga	toga
toga, togae F.	toga
tolero, tolerare, toleravi, toleratus	to bear, endure, tolerate
tollo, tollere, sustuli, sublatum	to raise, lift up, take away, remove, destroy
tollo, tollere, sustuli, sublatus	to lift up, raise, destroy, remove, steal
tot	so many
tōtus	whole
totus, tota, totum (adj.)	whole, all, total, entire, all together
totus, tota, totum (adj.)	whole, entire
trādidit	perfect - he/she handed over
trādit	he/she hands over
trado, tradere, tradidi, traditus	hand over, surrender, deliver
trahere, trāxī	perfect - he/she dragged
trahō	he/she drags
traho, trahere, traxi, tractus	to drag, draw, haul
traho, trahere, traxi, tractus	to draw, drag, haul
trans (prep.) + (accusative)	across
transeo, transire, tranii, transitus	to cross
trēs	three
tres, tres, tria (adj.)	three
triclīnium	dining room
triclinium, triclinii N.	dining room
tristis, tristis, triste (adj.)	sad
Troia, Troiae, F.	Troy (the city)
tū	you
tu (pronoun)	you
tu (pronoun)	you
tulit	perfect - he/she brought, carried
tum	then
tum (adv.)	then, at that time
tum (adv.)	then, next, besides
tunica	tunic
tunica, tunicae F.	tunic
turba	crowd
turba, turbae F.	crowd
turba, turbae F.	uproar, disturbance, mob, crowd, multitude
tutus, tuta, tutum (adj.)	safe
tuus	your
tuus, tua, tuum (adj.)	your
tuus, tua, tuum (adj.)	your, yours
tyrannus, tyranni M.	tyrant
ubi	where or when
ubi	where, when
ubi (adv.)	where, in what place, when, whenever
ubi (relative adv. or conj.)	where, when
ullus, ulla, ullum (adj.)	any
ultimus, ultima, ultimum (adj.)	farthest, extreme, last, final
ultra (adv.)	on the other side of, beyond
umbra	ghost, shadow
umbra, umbrae F.	shadow, ghost, shade
umerus, umeri, M.	shoulder
umquam	ever, at any time
unda, undae F.	wave
unde (adv.)	from where, whence
ūnus	one
unus, una, unum (adj.)	alone, one, single
unus, una, unum (adj.)	one
urbs	city
urbs, urbis F.	city
urbs, urbis F.	city
ut (conj.) + indicative verb	as, just as, when
uter, utra, utrum (adj.)	either, which (of two)
ūtilis	useful
utilis, utilis, utile (adj.)	useful, advantageous
utilis, utilis, utile (adj.)	useful, profitable, practical
uxor	wife
uxor, uxoris F.	wife
uxor, uxoris F.	wife
valdē	very much, very
valde (adv.)	very, very much
vale	goodbye
valē	goodbye
vale, valete	good-bye, farewell
valeo, valere, valui, valiturus	to be strong, have power, be well
vehementer	violently, loudly
vehementer (adv.)	violently, loudly
velle, voluī	perfect - he/she wanted
vēndit	he/she sells
vendo, vendere, vendidi, venditus	to sell
venenum, veneni N.	poison
venia, veniae F.	mercy
venio, venire, veni, ventus	to come
venio, venire, veni, ventus	to come
venit	he/she come or go
verberat	he/she strikes; beats
verberāvit	perfect - he/she struck; beat
verbero, verberare, verberavi, verberatus	to beat, strike
verbum, verbi N.	word
verbum, verbi, N.	word
veritas, veritatis F.	truth
versus, versus m.	line of verse
verto, vertere, verti, versum	to turn, change
verto, vertere, verti, versus	to turn, change, alter, overthrow, destroy
verum, veri N.	the truth
verus, vera, verum (adj.)	true, real, proper
vester, vestra, vestrum (adj.)	your, yours
vexo, vexare, vexavi, vexatus	to annoy, shake, harass
via	street
via, viae F.	street
via, viae F.	way, road, street
vicina, vicinae, F.	neighbor
vicinus, vicini, M.	neighbor
victoria, victoriae F.	victory
video, videre, vidi, visum	to see, observe
video,videre, vidi, visus	to see
videt	he/she sees
vīlla	house
villa, villae F.	house, villa
vinco, vincere, vici, victus	to conquer, defeat, outlast, succeed
vinco, vincere, vici, victus	to conquer, overcome
vīnum	wine
vinum, vini N.	wine
vir	man
vir, viri M.	man, hero
vir, viri M.	man, husband
virgo, virginis F.	maiden, young woman
virtus, virtutis F.	manliness, courage, worth, virtue
virtus, virtutis, F.	courage
vis, vis F.	force, power, violence
vīta	life
vita, vitae F.	life
vita, vitae F.	life
vitium, vitii N.	fault, crime, vice
vito, vitare, vitavi, vitatus	to avoid, evade, shun
vito, vitare, vitavi, vitatus	to avoid, shun
vituperat	he/she curses at
vitupero, vituperare, vituperavi, vituperatus	to find fault with, tell off, curse, scold
vivo, vivere, vixi, victus	to live
vivo, vivere, vixi, victus	to live
vix	hardly, scarcely
vocat	he/she calls
voco, vocare, vocavi, vocatus	to call, summon
voco, vocare, vocavi, vocatus	to call, summon, name
volō	he/she wants
volo, velle, volui, -	to wish, to want, to be willing
voluptas, voluptatis F.	pleasure
vōs	you (plural)
vos (pronoun)	you (plural), you all
vox, vocis F.	voice
vulgus, vulgi, N.	the common people, mob, rabble
vulnerāre, vulnerāvī	perfect - he/she wounded
vulnerō	he/she wounds
vulnero, vulnerare, vulneravi, vulneratus	to wound, injure, harm, damage
vulnus, vulneris N.	wound
vulnus, vulneris n.	wound, injury
