*Еде́мский Сад	Garden of Eden
Aаро́н	Aaron
або́рт	abortion
а́вгуст	August
Австра́лия	Austrailia
авто́бус	bus
автовокза́л	bus station
ад	hell
Ада́м	Adam
адвенти́ст седьмо́го дня	Seventh Day Adventist
адвока́т	attorney
администра́тор	administrator
а́дрес	address
А́зия	Asia
актёр	actor
акти́вность	activity (as a Church mem-ber)
акти́вный член Це́ркви	active member
аку́ла	shark
алкого́ль	alcohol
аллерги́я	allergies
алле́я	alley
А́лма	Alma
америка́нский футбо́л	football
анана́с	pineapple
а́нгел	angel
англи́йский	English
Анта́рктика	Antarctica
антибио́тик	antibiotic
аню́тины гла́зки	pansy
апельси́н	orange (fruit)
апо́стол	apostle
апре́ль	April
апте́ка	pharmacy
ара́хисовое ма́сло	peanut butter
аспири́н	aspirin
атеи́ст	atheist
А́фрика	Africa
ба́бочка	butterfly
ба́бушка	grandmother
бале́т	ballet
бана́н	banana
банк	bank
банкома́т	ATM
бапти́ст	Baptist
Бар Ми́тцва	Bar Mitzvah
баскетбо́л	basketball
батаре́йки	batteries
бато́нчик	candy bar
бег	running
бе́гать - бежа́ть / побежа́ть	to run (на, во что)
бе́дный	poor
безгре́шный	sinless
безопа́сность	safety
бейсбо́л	baseball
беко́н	bacon
бе́лый	white
бельё	laundry
бере́менная	pregnant
бесконе́чный	infinite
бескоры́стный	selfless
бессме́ртие	immortality
бессме́ртный	immortal
библиоте́ка	library
Би́блия	Bible
би́знес	business
биле́т	ticket
бинт	bandage
бифште́кс	steak
благодари́ть / поблагодари́ть	to thank (кого)(за кого-что)
благода́рность	gratitude
благода́рный	grateful
благослове́ние	blessing
благослове́ния	blessings
благословлённый	blessed (past part.)
благословля́ть / благослови́ть	to bless (кого-что)(чем)
бли́же	closer
блоха́	flea
блу́за	blouse
Бог	God
боже́ственный	divine
бо́жья коро́вка	ladybug
боле́ть / заболе́ть	to be sick (чем)
боле́ть / заболе́ть	to hurt (у кого)
боль	pain
больни́ца	hospital
больно́е го́рло	sore throat
больно́й	sick, achy
бо́льше	larger, greater, more of
большо́й	big, large
большо́й па́лец	thumb
боти́нки	boots
брак	marriage
бракосочета́ние	marriage ceremony
брасле́т	bracelet
брат	Brother
брать / взять	to take (кого-что)
брать / взять	to take (кого-что)
брать / взять на себя́	to take upon oneself (что)
брать / взять на себя́	to take upon oneself (что)
бре́мя	burden
бри́тва	razor
брить / побри́ть	to shave (кого-что)
бри́ться / побри́ться	to shave oneself
бро́кколи	broccoli
броса́ть / бро́сить	to quit (give up) (что)
будди́ст	Buddhist
бу́лочная	bakery
бума́жник	wallet
бу́ря	storm
бутербро́д	sandwich
буфе́т	cupboard
быть гото́вым / стать гото́вым	to be ready (к чему)
бюстга́лтер	bra
в	in (ком-чём)
в	in, into (кого-что)
в депре́ссии	depressed
в оди́н коне́ц	one-way
в то вре́мя как	while
ваго́н	car, wagon
ва́жный	important
вани́ль	vanilla
ва́нна	bathtub
ва́нная	bathroom
варе́нье	jam
вари́ть / свари́ть	to boil (что)
ва́фля	waffle
ваш	your
вдова́	widow
вдове́ц	widower
вдохнове́ние	inspiration
вдруг	suddenly
ведро́	bucket
век	century, age, lifetime
вели́кий	great
велосипе́д	bicycle
ве́ник	broom
ве́нчик	wire whisk
ве́ра	faith, belief
ве́рить / пове́рить	to believe (в кого-что)(кому-чему)
ве́рность	faithfulness, fidelity
ве́рный	faithful, true
ве́рующий	religious, believing
вес	weight
весна́	spring
ве́тер	wind
ветря́нка	chicken pox
Ве́тхий Заве́т	Old Testament
ветчина́	ham
ве́чер	evening
ве́чер встре́чи	fireside
вечери́нка	party
ве́чером	in the evening
ве́чная жизнь	eternal life
ве́чно	eternally
ве́чность	eternity
ве́чный	eternal
ве́чный	everlasting
ви́деть / уви́деть	to see (кого-что)
ви́лка	fork
вина́	guilt
вини́тельный паде́ж	accusative case
вино́	wine
виногра́д	grapes
Вифлее́м	Bethlehem
ви́шня	cherry
вклад	deposit
вкус	taste
вла́жность	humidity
власть	authority, power, rule
влия́ние	influence
вме́сте	together
внизу́	below
вноси́ть / внести́	to contribute (что)
внук	grandson
внутри́	inside (of), within
вну́чка	granddaughter
вода́	water
води́ть - вести́ / повести́	to drive (что)
возвраща́тьcя / верну́ться	to return (к кому-чему)
возвыше́ние	exaltation
во́здух	air
во́зле	next to (кого-чего)
возложе́ние рук	laying on of hands
возлю́бленный	beloved
возмеще́ние	restitution
возмо́жность	opportunity
возрожде́ние	rebirth
возрождённый	reborn
война́	war
волне́ние	disturbance
волне́ние	disturbance
во́ля	will
вопро́с	question
воротни́к	collar
восемна́дцатый	eighteenth
восемна́дцать	eighteen
во́семь	eight
во́семьдесят	eighty
воскресе́ние	resurrection
воскресе́нье	Sunday
Воскре́сная шко́ла	Sunday School
воспале́ние лёгких	pneumonia
восстановле́ние	restoration
восто́к	East
восьмидеся́тый	eightieth
восьмо́й	eighth
враг	enemy
врач	doctor
вре́дный	harmful
вре́менный	temporal
вре́мя	time
все	all
все	everyone
всегда́	always
вслух	aloud
встава́ть / встать	to stand up (с чего)
встава́ть / встать на коле́ни	to kneel (на что)
встре́ча	appointment, meeting
встреча́ться / встре́титься	to meet (с кем-чем)
вступи́тельная моли́тва	opening prayer
вступи́тельный гимн	opening hymn
втора́я специа́льность	minor
вто́рник	Tuesday
второ́е прише́ствие	second coming
второ́й	second
второ́й эта́ж	second floor
вчера́	yesterday
Вы	you (formal, singular)
вы	you (plural)
выбира́ть / вы́брать	to choose (кого-что)(между кем-чем)
вы́бор	choice
выполня́ть / вы́полнить	to keep, fulfill (что)
выража́ть / вы́разить	to express (что)(кому)
высо́кая температу́ра	high temperature
выступа́ть / вы́ступить	to speak, give a talk (перед кем-чем)(о ком-чём)
выступа́ющий	speaker
вытират́ь / вы́тереть пыль	to dust (что)
вытират́ь / вы́тереть пыль	to dust (что)
вы́ше	higher
выясня́ть / вы́яснить	to find out, clear up (что)
газо́н	lawn
га́лстук	tie
гара́ж	garage
где	where
Гелама́н	Helaman
гель	gel
генеало́гия	genealogy
гигиени́ческая пома́да	chap stick
гита́ра	guitar
глава́	chapter, head (of organiza-tion)
говори́ть / поговори́ть	to talk (с кем)(о ком-чём)
говори́ть / сказа́ть	to say (о ком-чём)(кому)
голова́	head
головна́я боль	headache
го́лод	hunger
го́лос	voice
голосова́ть / проголосова́ть	to vote (за кого-что)
гольф	golfing
гомосексуа́льный	homosexual
гора́	mountain
го́рдый	proud
го́рло	throat
го́род	city
городо́к	town
городско́й сове́т	city hall
горо́шек	peas
горчи́ца	mustard
Госпо́дь	Lord
гости́ная	living room
гость	guest (visitor)
гото́вить / подгото́вить	to prepare (кого-что)(для кого-чего)
гото́вить / пригото́вить	to cook (что)
гото́виться / подгото́виться	to prepare oneself (к чему)(на кого-что)
гото́вый	willing
град	hail
граждани́н	citizen
гражда́нский	civil
гражда́нство	citizenship
гремит / прогреми́т гром	it's thundering
грех	sin
грипп	flu
гром	thunder
грудь	chest
гру́ппа	group
гру́стный	sad
гру́ша	pear
гу́бка	sponge
гу́бы	lips
гуманита́рные нау́ки	humanities
дyхо́вно	spiritually
дава́ть / дать	to give (кому)(что)
далеко́	far
дар	gift
дар Свято́го Ду́ха	gift of the Holy Ghost
дарова́ть	to confer (кому)(кого-что)
дарова́ть Свято́го Ду́ха	to confer the Holy Ghost (кого)
да́тельный паде́ж	dative case
два	two
двадца́тый	twentieth
два́дцать	twenty
двена́дцатый	twelfth
двена́дцать	twelve
дверь	door
двор	yard
двою́родная сестра́	cousin (female)
двою́родный брат	cousin (male)
девяно́сто	ninety
девяно́стый	ninetieth
девятна́дцатый	nineteenth
девятна́дцать	nineteen
девя́тый	ninth
де́вять	nine
де́душка	grandfather
дезодора́нт	deodorant
де́йствовать / поде́йствовать	to act, affect (на кого-что)
дека́брь	December
де́лать / сде́лать заря́дку	to exercise (что)
де́лать / сде́лать поку́пки	to shop (что)
дели́ться / подели́ться	to share (чем)(с кем-чем)
де́ло	action, doing
день	day, afternoon
День Незави́симости	Independence Day
день подгото́вки	preparation day
день рожде́ния	birthday
день суббо́тний	Sabbath
де́ньги	money
дере́вня	village
де́рево	tree
держа́ть / подержа́ть	to hold (кого-что)(за что)
дёсны	gums
деся́тая часть	tenth
деся́тая часть	tenth
десяти́на	tithing, tithe
деся́тый	tenth (ordinal)
де́сять	ten
де́ти	children
дёшево	cheap
джи́нсы	jeans
Джо́зеф Смит	Joseph Smith
Джон Ви́клиф	John Wycliffe
Джон Ка́львин	John Calvin
дива́н	sofa
дирижи́ровать / подирижи́ровать	to conduct (music) (что)
дитя́	child, baby
дли́нный	long
до	before, until (кого-чего)
добива́ться / доби́ться успе́ха	to succeed (чего)
добро́	good (n.)
доброво́лец	volunteer
до́брый	kind
дове́рие	trust
доверя́ть / дове́рить	to trust (кому-чему)(что)
дово́льный	content (adj.)
догово́р	agreement
дождь	rain
до́за	dosage
доказа́тельство	evidence
дока́зывать / доказа́ть	to prove (кому-чему)(что)
долг	duty
доли́на	valley
дом	home, house
дома́шний	home (adj.)
дома́шний учи́тель	home teacher
доро́га	road
до́рого	expensive
доска́	chalkboard
достига́ть / дости́чь	to achieve, accomplish (чего)
досто́йный	worthy
дохо́д	income
дочь	daughter
Драгоце́нная Жемчу́жина	Pearl of Great Price
дре́вний	ancient
друг	friend
други́е	others
друго́й	another, other
дружелю́бный	friendly
дуб	oak
ду́ет ве́тер	the wind is blowing
ду́ет ве́тер	the wind is blowing
ду́мать / поду́мать	to think (о ком-чём) (над чем)
дуршла́г	strainer
дух	spirit
духо́вка	oven
духо́вный	spiritual
духо́вный мир	spirit world
душ	shower
души́ца	oregano
ды́рка в зу́бе	cavity
дья́вол	devil
дья́кон	deacon
дя́дя	uncle
Е́ва	Eve
Ева́нгелие	gospel
евре́й	Jewish
Евро́па	Europe
его́	his
еда́	food, meal
еди́нственное число́	singular quantity
её	her
еженеде́льный	weekly
е́здить - е́хать / пое́хать	to go by vehicle (чем)
Е́нос	Enos
Е́нох	Enoch
епи́скоп	bishop
епи́скопство	bishopric
Е́фер	Ether
жа́жда	thirst
жара́	heat
жа́реная ку́рица	fried chicken
ждать / подожда́ть	to wait (кого-что)(кого-чего)
жела́ние	desire, intent
жела́ть / пожела́ть	to desire (кому-чему)(чего)
желе́зная доро́га	railroad tracks
железнодоро́жный вокза́л	train station
жёлтый	yellow
желу́док	stomach
жена́	wife
же́нский род	feminine gender
же́нщина	woman
же́ртва	sacrifice
же́ртвование	sacrifice, donating
же́ртвовать / поже́ртвовать	to sacrifice, to donate (чем)
живо́т	belly
живо́тное	animal
живо́тное	animal
живу́щие отде́льно	separated (marital)
жизнь	life
жить / пожи́ть	to live (на, в чём)
журна́л	magazine
за	behind, after (кем-чем)
забе́г	race
забо́р	fence
забо́та	concern
заве́т	covenant
заве́ты	covenants
за́втра	tomorrow
за́втрак	breakfast
зада́ние	task
зака́нчивать / зако́нчить	to close, finish (что)
заключа́ть / заключи́ть заве́т	to covenant (что)(с кем)
заключи́тельная моли́тва	closing prayer
заключи́тельный гимн	closing hymn
зако́н	law
зако́н целому́дрия	law of chastity
зако́нный	lawful, legal
закрыва́ть / закры́ть	to close (что)
зал	hall
зало́женный нос	stuffy nose
занима́ться / заня́ться	to practice (чем)
занима́ться / заня́ться спо́ртом	to do sports (чем)
за́пад	West
запека́нка	casserole
запеча́тывание	sealing
запеча́тывать / запеча́тать	to seal (кого-что)(на что)
запи́сывать / записа́ть	to write down (кому)(что)
за́пись	record
за́поведи	commandments
запове́довать / запове́дать	to command (кому-чему)(что)
за́поведь	commandment
запра́вочная	gas station
запре́тный	forbidden
запя́стье	wrist
заря́дка	exercise
заходи́ть / зайти́	to come by (к кому)
заявле́ние	application
заявля́ть / заяви́ть	to declare (что)(кому-чему)
заявля́ть / заяви́ть	to state (что)(кому-чему)
звони́ть / позвони́ть	to call by phone (кому)
звук	sound
зда́ние	building
здесь	here
здесь	here
здо́рово	splendid
здоро́вье	health
зелёный	green
землетрясе́ние	earthquake
земля́	earth
земно́й	earthly
зима́	winter
зла́ки	grain
злой	evil
злость	anger
змея́	snake
знак	sign
зна́ние	knowledge
знать	to know (кого-что)(о ком-чём)
зо́на	zone
зо́нтик	umbrella
зре́ние	sight
зуб	tooth
зубна́я нить	floss
зубна́я па́ста	toothpaste
зубна́я щётка	toothbrush
зу́бы	teeth
зять	son-in-law
Иа́ков	Jacob
Иа́ков	James
Иаро́м	Jarom
игнори́ровать / проигнори́ровать	to ignore (кого-что)
иго́лка	needle
игра́	game
игра́ть / поигра́ть	to play (an instrument) (на чём)
игра́ть / поигра́ть	to play (sport) (во что)
идёт / пойдёт дождь	it's raining
идёт / пойдёт снег	it's snowing
Иерусали́м	Jerusalem
избега́ть / избежа́ть	to avoid (кого-чего)
избира́ть / избра́ть	to elect (кого-что)
изменя́ть / измени́ть	to change (кого-что)
изобрази́тельное иску́сство	visual art
Изра́иль	Israel
изуча́ть / изучи́ть	to study, research (кого-что)
изуче́ние с напа́рником	companionship study
Иису́с Христо́с	Jesus Christ
Илия́	Elijah
имени́тельный паде́ж	nominative case
име́ть	to have, to possess (что)
име́ть жела́ние	to be willing, have a desire (что)
име́ть жела́ние	to be willing, have a desire (что)
иммигра́нт	immigrant
и́мя	name
ингридие́нт	ingredient
инде́йка	turkey
индивидуа́льное заня́тие	personal study
индивидуа́льный	individual (adj.)
инду́с	Hindu
инжене́рия	engineering
иногда́	sometimes
иностра́нные языки́	foreign languages
инструме́нт	instrument
интервью́	interview (job)
Иоа́нн	John
Иоа́нн Крести́тель	John the Baptist
Ио́в	Job
искажа́ть / искази́ть	to distort (что)
иска́ть / поиска́ть	to search (кого-что)
и́скренне	sincerely
и́скренний	sincere
Искупи́тель	Redeemer
Искупле́ние	Atonement
искупля́ть / искупи́ть	to atone (кого-что)
иску́сство	art
искуше́ние	temptation
и́споведь	confession
испо́льзовать	to use (кого-что)
испыта́ние	trial, test
испыта́тельный срок	probationary period
испы́тывать / испыта́ть	to experience (что)
истека́ть / исте́чь кро́вью	to bleed (чем)
и́стина	truth
и́стинный	true
исто́рия	history, account
исто́чник	source
исцеле́ние	healing
Иу́да Искарио́т	Judas Iscariot
ию́ль	July
ию́нь	June
йо́гурт	yogurt
как	how
как до́лго	how long
ка́мень	rock
каранда́ш	pencil
каранда́ш для губ	lip liner
каранда́ш для подво́дки глаз	eyeliner
карма́н	pocket
ка́рта	map
карти́на	picture, painting
карто́фель	potato
карто́фельное пюре́	mashed potatoes
карье́ра	career
кастрю́ля	pot
ката́ние на велосипе́де	biking
ката́ться / поката́ться на велосипе́де	to ride a bicycle (на чём)
ката́ться / поката́ться на лы́жах	to ski (на чём)
като́лик	Catholic
ка́яться / пока́яться	to repent (в чём)
кварта́л	block
кварти́ра	apartment
кво́рум	quorum
ке́тчуп	ketchup
киломе́тр	kilometer (0.62 miles)
кит	whale
клавиату́ра	keyboard
кла́дбище	cemetery
класс	class
класс	classroom
класс	grade level
клён	maple
клерк	clerk
ключи́	keys
кни́га	book
Кни́га Мормо́на	Book of Mormon
кно́пка	button
ковёр	carpet
когда́	when
ко́жа	leather
ко́жа	skin
козёл	goat
колбаса́	sausage
колго́тки	nylons
коле́ни	knees
коле́но	knee
ко́лледж	college
кольцо́	ring
кома́р	mosquito
комбина́ция	slip
ко́мната	room
компа́ния	company
компью́тер	computer
компью́терные и́гры	computer games
компью́терные нау́ки	computer science
конве́рт	envelope
кондиционе́р для воло́с	conditioner
консе́рвный нож	can opener
конта́кт	contact
контине́нт	continent
конфере́нция	conference
конфере́нция зо́ны	zone conference
конфере́нция ми́ссии	mission conference
конфирма́ция	confirmation
конце́рт	concert
кооперати́вная кварти́ра	condominium
кора́бль	ship
кори́ца	cinnamon
кори́чневый	brown
коро́ва	cow
коро́ткий	short
коро́че	shorter
корь	measles
косме́тика	makeup
кость	bone
костю́м	suit
кот	cat
ко́фе	coffee
кошелёк	purse
краб	crab
краеуго́льный ка́мень	cornerstone
кра́сный	red
красота́	beauty
креве́тка	shrimp
креди́тная ка́рточка	credit card
крем	lotion
крем для бритья́	shaving cream
кре́пкий	strong, solid, firm
крест	cross
крести́ть / покрести́ть	to baptize (кого)
крести́ться / покрести́ться	to be baptized (в чём)(за кого)
креще́ние	baptism
крова́ть	bed
кровоточи́ть	to bleed (e.g. nosebleed)
кровь	blood
кроссо́вки	tennis shoes
кру́жка	mug
кто	who
кукуру́за	corn
культу́ра	culture
купю́ра	bill
ку́рица	chicken
ку́хня	kitchen
лаза́нья	lasagna
ла́мпа	lamp
ла́ндыш	lily
лев	lion
ле́во	left
лега́льный	legal
лёгкие	lungs
леденцы́ от ка́шля	cough drops
лес	forest
ле́то	summer
ли́дер зо́ны	zone leader
ли́дер о́круга	district leader
литерату́ра	literature
лихора́дка	fever
ли́чное вре́мя	personal time
ли́чность	personality, individual
ли́чный	personal, individual, private
лоб	forehead
ло́дка	boat
лоды́жка	ankle
ло́жка	spoon
ло́коть	elbow
ло́шадь	horse
лук	onion
Лука́	Luke
луна́	moon
лу́чше	better
люби́ть / полюби́ть	to love (кого-что)
любо́вь	love
любо́й	any
лю́бящий	loving
лю́ди	people
лютера́нин	Lutheran
магази́н	store
магистра́ль	highway
мазь	ointment
май	May
майоне́з	mayonnaise
макаро́ны	pasta
Мала́хия	Malachi
ма́ленький	small
Мари́я	Mary
Марк	Mark
ма́рка	stamp
март	March
Ма́ртин Лю́тер	Martin Luther
ма́сло	oil, butter
матема́тика	mathematics
материа́льный	material
Матфе́й	Matthew
матч	match
мать	mother
ма́чеха	step-mother
маши́на	car
ме́бель	furniture
мёд	honey
медбра́т	nurse (male)
медици́на	medicine
ме́дный	brass (adj.)
медсестра́	nurse (female)
ме́жду	between (кем-чем)
мел	chalk
Мелхиседе́к	Melchizedek
ме́нее акти́вный член Це́ркви	less active member
ме́рная кру́жка	measuring cup
ме́рная ло́жка	measuring spoon
мероприя́тие	activity (event)
Месси́я	Messiah
ме́сто	place
местоиме́ние	pronoun
ме́сяц	month
мете́ль	blizzard
методи́ст	Methodist
метр	meter (3.28 feet)
метро́	subway
меха́ник	mechanic
микроволно́вка	microwave
микрофо́н	microphone
милице́йский уча́сток	police station
милиционе́р	policeman
миллиа́рд	one billion
миллиа́рдный	one billionth
миллио́н	one million
миллио́нный	one millionth
милосе́рдие	charity, mercy
ми́лость	grace
ми́ля	mile (1.61 kilometers)
мину́та	minute
мир	peace, world
ми́рный	peaceful
ми́ска	bowl
миссионе́р	missionary
миссионе́р прихо́да	ward missionary
миссионе́рская рабо́та	missionary work
ми́ссия	mission
младе́нец	baby
мно́жественное число́	plural quantity
моги́ла	grave
мозг	brain
Моисе́й	Moses
моли́тва	prayer
моли́твенный дом	meetinghouse
моли́ть / помоли́ть	to plead (кого)(о ком-чём)
моли́ться / помоли́ться	to pray (кому-чему)(о ком-чём)
молоды́е же́нщины	young women
молоды́е мужчи́ны	young men
молоко́	milk
моне́та	coin
мо́ре	sea
морко́вь	carrot
Мормо́н	Mormon (prophet)
мормо́н	Mormon (religion)
моро́женое	ice cream
морози́лка	freezer
Моро́ний	Moroni
морска́я звезда́	starfish
Мо́сия	Mosiah
мост	bridge
мотоци́кл	motorcycle
му́дрость	wisdom
муж	husband
мужско́й род	masculine gender
мужчи́на	man
музе́й	museum
му́зыка	music
музыка́льная гру́ппа	band
мука́	flour
му́ка	suffering, torment, torture
мураве́й	ant
му́ха	fly
мы	we
мы́ло	soap
мысль	thought
мыть / помы́ть	to wash (кого-что)
мыть / помы́ть пол	to mop (что)
мышь	mouse
мясно́й руле́т	meatloaf
мя́со	meat
мяч	ball
на	on (ком-чём)
на	on, onto (кого-что)
наве́рно	probably
наве́чно	forever
навеща́ющая сестра́	visiting teacher
на́вык	skill
над	over (кем-чем)
наде́жда	hope
наделённый вла́стью	authorized (adj.)
наде́яться / понаде́яться	to hope (на кого-что)
наза́д	back(wards), rearward
назва́ние	title
наказа́ние	penalty
накла́дывать / наложи́ть макия́ж	to put on makeup (что)(на что)
наконе́ц	finally
нали́чные	cash
наме́рение	intent, design, purpose
напа́рник	companion
напа́рничество	companionship
напи́ток	beverage
напомина́ние	reminder
напомина́ть / напо́мнить	to remind (кому-чему)(о ком-чём)(кого)
напро́тив	across from (кого-чего)
нарко́тик	drug
наслажда́ться / наслади́ться	to enjoy (чем)
на́сморк	runny nose
наставле́ние	instruction
нау́ка	science
нау́шники	headset
находи́ть / найти́	to find (кого-что)
нача́льная шко́ла	elementary school
начина́ть / нача́ть	to begin (что)(с кого-чего)
не слу́шаться / не послу́шаться	to disobey (кого-чего)
небеса́	heaven
Небе́сный Оте́ц	Heavenly Father
не́бо	sky
неве́стка	daughter-in-law
неде́ля	week
нежена́тый	single (man)
незаму́жняя	single (woman)
ненави́деть / возненави́деть	to hate (кого-что)
необходи́мый	necessary
непра́вильный	wrong
неприя́тность	trouble
несоверше́нный	imperfect
несча́стный слу́чай	accident
Не́фий	Nephi
Нефи́йцы	Nephites
неча́сто	rarely
нечести́вый	wicked
ни́же	lower
ни́жний эта́ж	basement, lower floor
никогда́	never
новообращённый	new convert
но́вый	new
Но́вый Заве́т	New Testament
но́вый член Це́ркви	new member
нога́	leg, foot
нож	knife
Ной	Noah
но́мер	number
нос	nose
носи́ть - нести́ / понести́	to carry (кого-что)
носи́ть - нести́ / понести́	to hold, carry (кого-что)
носи́ть / выноси́ть	to wear (что)
носки́	socks
ночь	night
ноя́брь	November
нра́виться / понра́виться	to like (impers.) (кому-чему)(кто-что)
нра́вственные но́рмы Ева́нгелия	gospel standards
нужда́	need
нужда́ющиеся	needy (pl.)
о	about (ком-чём)
обе́д	lunch
обезья́на	monkey
обеща́ние	promise
о́блако	cloud
облече́ние	endowment
ободре́ние	encouragement
ободря́ть / ободри́ть	to encourage (кого)
обоня́ние	smell
о́браз	form, image, pattern, way
образцо́вые труды́	standard works
обра́тно	back, inversely
обраща́ться / обрати́ться	to address (к кому-чему)
обрета́ть / обрести́	to obtain (кого-что)
обря́д	ordinance, ceremony
обсужда́ть / обсуди́ть	to discuss (кого-что)
обща́ться / пообща́ться	to communicate (с кем)
общежи́тие	dormitory
о́бщество	society
О́бщество милосе́рдия	Relief Society
общи́на	community
объявля́ть / объяви́ть	to announce (кому-чему)(кого-что)
объясня́ть / объясни́ть	to explain (кому-чему)(что)
обы́чно	usually
обяза́тельство	commitment, obligation
обя́зывать / обяза́ть	to commit (to obligate) (кого)(к чему)
обя́зываться / обяза́ться	to commit oneself (к чему)
овёс	oats
о́вощ	vegetable
овца́	sheep
оде́жда	clothes
оди́н	alone
оди́н	one
оди́ннадцатый	eleventh
оди́ннадцать	eleven
ожере́лье	necklace
ожида́ть	to expect (кого-чего)
озада́ченный	confused, perplexed, puzzled
о́зеро	lake
озно́б	chills
ока́зывать / оказа́ть	to provide (кому-чему)(что)
океа́н	ocean
окно́	window
о́круг	district
октя́брь	October
ола́дья	pancake
О́ливер Ка́удери	Oliver Cowdery
О́мний	Omni
он	he
она́	she
они́	they
оно́	it
о́пера	opera
опи́сывать / описа́ть	to describe (кого-что)
о́пыт	experience
опя́ть	again
ора́нжевый	orange (color)
орга́н	organ
организа́ция	organization
организо́вывать / организова́ть	to organize (кого-что)
орке́стр	orchestra
ору́дие	tool
освяща́ть / освяти́ть	to sanctify (кого-что)( в кого-что)
освящённый	consecrated
о́сень	autumn, fall
основа́ние	foundation
осно́вывать / основа́ть	to establish (что)(на ком-чём)
особня́к	town house
осознава́ть / осозна́ть	to recognize (что)
отверга́ть / отве́ргнуть	to reject (кого-что)
отве́т	answer
отве́тственность	responsibility, accountability
отве́тственность	stewardship
отве́тственный	responsible
отвеча́ть / отве́тить	to answer (на что)(перед кем)
отде́л	department
отделённый	separated
о́тдых	rest
оте́ц	father
Оте́ц	Father
открове́ние	revelation
открыва́ть / откры́ть	to reveal (что)(кому-чему)
отлича́ть / отличи́ть	to distinguish (кого-что) (от кого-чего)
отли́чно	outstanding
отноше́ние	relationship
отправля́ться / отпра́виться	to depart (на чём)
отпуще́ние грехо́в	remission of sins
отры́вок	passage
отсту́пничество	apostasy
о́тчим	step-father
о́фис	office
оце́нка	grade
очища́ть / очи́стить	to cleanse (кого-что)(чем)
очки́	glasses
оши́бка	mistake
ощуща́ть / ощути́ть	to feel (body senses) (кого-что)
ощуще́ние	sense
Па́вел	Paul
паде́ж	case
Паде́ние	Fall
па́дчерица	step-daughter
пальто́	coat
па́ра	couple (married/senior)
парикма́херская	barber shop
парк	park
па́рта	school desk
па́спорт	passport
па́стор	pastor
Па́сха	Easter
па́сынок	step-son
патриа́рх	patriarch
пау́к	spider
педаго́гика	pedagogy
Первонача́льное о́бщество	Primary
пе́рвый	first
пе́рвый эта́ж	first floor
пе́ред	in front of (кем-чем)
перекрёсток	intersection
переме́на	change
переса́живаться / пересе́сть	to transfer to (на что)
перестава́ть / переста́ть	to stop
пе́рец	pepper
пери́од	period
перло́вая крупа́	barley
пе́рсик	peach
перча́тка	glove
Пётр	Peter
петь / спеть	to sing (что)
пече́нье	cookie
пи́во	beer
пиджа́к	suit coat
пижа́ма	pajamas
пиро́г	pie
писа́ния	scriptures
писа́ть / написа́ть	to write (что)(кому-чему)
пи́сьменный стол	desk
письмо́	letter
пить / вы́пить	to drink (что)(чего)
питьё	drink
пи́цца	pizza
пи́ща	food
пла́вание	swimming
пла́вать / попла́вать	to swim
план	plan
плати́ть / заплати́ть	to pay (за кого-что)(чем)
пла́тье	dress
племя́нник	nephew
племя́нница	niece
плечо́	shoulder
плита́	stove
плод	fruit (biblical sense)
пломби́ровать / запломби́ровать	to fill (teeth) (что)
плоть	flesh
плохо́й	bad
побежда́ть / победи́ть	to overcome, win, be victori-ous (кого-что)
поведе́ние	behavior
повинова́ться	to obey, submit oneself to (кому-чему)
повинове́ние	obedience, submission
повторя́ть / повтори́ть	to repeat (что)(кому)
пого́да	weather
погребе́ние	burial
погружа́ть / погрузи́ть	to immerse (кого-что)(во что)
погруже́ние	immersion
под	under (кем-чем)
подава́ть / пода́ть заявле́ние	to apply for (что)(на что)
пода́рок	gift, present
подборо́док	chin
подва́л	basement, cellar
подде́рживать / поддержа́ть	to support (кого-что)
подде́рживать / поддержа́ть	to sustain (кого-что)
подде́ржка	support
подмета́ть / подмести́	to sweep (что)
подсо́лнух	sunflower
подстрига́ть / подстри́чь	to cut (hair) (что)
подтвержда́ть / подтверди́ть	to confirm (что)(чем)
подтвержде́ние свиде́тельства	confirmation of testimony
подходи́ть / подойти́	to fit (кому)
подъю́бник	slip (underskirt)
по́езд	train
пое́здка	trip
поже́ртвование	offering
поже́ртвование от поста́	fast offering
позади́	behind, past, in back of (кого-чего)
по́зже	later (synonymous to потом)
пока́	while (synonymous to в то время как)
покая́ние	repentance
поклоне́ние	worship
поклоня́ться / поклони́ться	to worship (кому-чему)
поко́й	peace, rest, calm
покупа́ть / купи́ть	to buy (кого-что)(у кого-чего)
пол	floor
полага́ться / положи́ться	to rely (на кого-что)
по́ле миссионе́рской де́ятельности	mission field
поле́зный для здоро́вья	healthy
по́лка	shelf
по́лное и́мя	full name
полномо́чие	authority, commission
полнота́	fullness
по́лный	complete
полово́й	sexual
получа́ть / получи́ть	to receive (что)
пома́да	lipstick
пома́зание	anointing
пома́зывать / пома́зать	to anoint (кого-что)(чем)
по́мнить / вспо́мнить	to remember (кого-что)(о ком-чём)
помо́лвленный	engaged
помо́щник президе́нта	assistant to the president
по́мощь	help
понеде́льник	Monday
понима́ние	understanding
понима́ть / поня́ть	to understand (кого-что)
По́нтий Пила́т	Pontius Pilate
поп	pope
попко́рн	popcorn
портфе́ль	briefcase
поря́док	order
посвяща́ть / посвяти́ть	to ordain (кого-что)
посвяще́ние	ordination
посеща́ть / посети́ть	to attend (кого-что)
посеща́ть / посети́ть	to visit (кого-что)
посеще́ние	visit
посла́нник	messenger
по́сле	after (кого-чего)
после́дний	last
после́довательный	consecutive
после́дствие	consequence
послуша́ние	obedience
послу́шный	obedient
пост	fasting
пости́ться / попости́ться	to fast (о чём)
постоя́нный	constant
поступа́ть / поступи́ть	to act, behave
посту́пок	action, deed, conduct
посу́да	dishes
посудомо́ечная маши́на	dishwasher
посы́лка	package
пото́м	later (synonymous to позже)
пото́мство	posterity
пото́п	flood
похо́д	camping
по́хороны	funeral
по́чва	dirt
почему́	why
почита́ть / почти́ть	to honor, esteem, respect (кого-что)
по́чта	mail
по́чта	post office
почте́ние	respect
почто́вая откры́тка	post card
почто́вый код	postal code
почто́вый я́щик	mailbox
пра́ведность	righteousness
пра́ведный	righteous
пра́вило	rule
пра́вильный	right (correct)
прави́тельство	government
пра́во	right (priviledge)
пра́во	right (side)
правове́дение	law (school subject)
правосу́дие	justice
пра́здновать / отпра́здновать	to celebrate (что)
пра́ктика	internship
пра́чечная	laundry room
пра́чечная самообслу́живания	laundromat
пребыва́ть / пребы́ть	to dwell (в чём)(с кем)
пре́данность	loyalty
предлага́ть / предложи́ть	to offer (кого-что)(кому-чему)
предло́жный паде́ж	prepositional case
пре́док	ancestor
предполага́емый слу́шатель	referral
председа́тельствовать / попредседа́тельствовать	to preside (над кем-чем)
представи́тель	representative
представля́ть / предста́вить	to represent (кого-что)
пре́жде	before, formerly
пре́жде чем	before, prior to
президе́нт	president
президе́нт ко́ла	stake president
президе́нт ми́ссии	mission president
президе́нт о́круга	district president
президе́нт прихо́да	branch president
президе́нт ЦПМ	MTC president
прекра́сно	wonderful
прелюбодея́ние	adultery
преодолева́ть / преодоле́ть	to overcome, master (кого-что)
преподава́тель	instructor
препя́тствие	obstacle
пресвитериа́нин	Presbyterian
преступле́ние	crime
претерпева́ть / претерпе́ть	to endure (что)(до чего)
прибира́ться / прибра́ться	to organize (to clean the house) (что)
прибыва́ть / прибы́ть	to arrive (во что)
приве́тствовать / поприве́тствовать	to welcome (кого-что)
привиле́гия	privilege
приглаша́ть / пригласи́ть	to invite (кого)(на что)
приглаше́ние	invitation
приезжа́ть / прие́хать	to come by vehicle (на чём)(чем)(к кому)
приём пи́щи	meal
приём у врача́	doctor's appointment
призва́ние	calling
при́званный	called
признава́ть / призна́ть	to admit (что)
признава́ть / призна́ть	to recognize, acknowledge, admit (кого-что)
призыва́ть / призва́ть	to call (кого)(на что)
прила́вок	counter
применя́ть / примени́ть	to apply (что)
приме́р	example
принима́ть / приня́ть	to accept, receive, partake (кого-что)
принима́ть / приня́ть ва́нну	to bathe (что)
принима́ть / приня́ть душ	to shower (что)
приноси́ть / принести́	to bring, to offer (кого-что)
при́нцип	principle
припра́ва	seasoning
приро́да	nature
прислу́живать / прислужи́ть	to administer (кому-чему)
прису́тствие	presence
приходи́ть / прийти́	to come (на, во что)(к кому)
прича́стие	sacrament, communion
прича́стное собра́ние	sacrament meeting
прича́стный зал	chapel
причёсываться / причеса́ться	to comb (чем)
причи́на	reason
пробле́ма	problem
проверя́ть / прове́рить	to check (кого-что)
проверя́ть / прове́рить	to test, to check (кого-что)
прови́дец	seer
програ́мма	program
программи́ст	computer programmer
прогре́сс	progress
прогу́лка в гора́х	hiking
продолжа́ть / продо́лжить	to continue (что)
продукто́вый магази́н	grocery store
прое́зд	drive
проезжа́ть / прое́хать	to pass by vehicle (мимо кого-чего)
пропове́довать / пропове́дать	to preach (кого-что)(кому-чему)
проро́к	prophet
проро́чество	prophecy
проси́ть / попроси́ть	to ask for goods, services, people (кого-что)(о чём)(у кого)
просла́вленный	glorified
проспе́кт	avenue
просту́да	cold
протеста́нт	Protestant
протестова́ть / запротестова́ть	to protest (против кото-чего)
проти́вник	adversary
проходи́ть / пройти́	to pass on foot (мимо кого-чего)(что)
проце́сс	process
про́шлое	past (noun)
про́шлый	past (adj.)
проща́ть / прости́ть	to forgive (кого-что)(кому)
проще́ние	forgiveness
пруд	pond
пря́мо впереди́	straight ahead
прямо́й и у́зкий путь	strait and narrow path
психоло́гия	psychology
пти́ца	bird
пу́динг	pudding
пусты́ня	desert
пу́таница	confusion
путеше́ствие	journey
путеше́ствие	traveling
путеше́ствовать / попутеше́ствовать	to travel (чем)(по чему)
путь	way, path
пчела́	bee
пшени́ца	wheat
пылесо́с	vacuum
пылесо́сить / пропылесо́сить	to vacuum (что)
пье́са	play
пятидеся́тник	Pentecostal
пятидеся́тый	fiftieth
пя́тка	heel
пятна́дцатый	fifteenth
пятна́дцать	fifteen
пя́тница	Friday
пя́тый	fifth
пять	five
пятьдеся́т	fifty
рабо́та	work, job
рабо́тать / порабо́тать	to work (кем-чем) (на, в чём)
работода́тель	employer
равви́н	rabbi
ра́дио	radio
ра́достный	joyful
ра́дость	joy
разведённый	divorced
развива́ться / разви́ться	to develop (в чём)
разде́л	section
разме́р	size
разме́шивать / размеша́ть	to stir (что)(чем)
размышля́ть / поразмышля́ть	to ponder (над чем)
ра́зный	different
разы́грывание ситуа́ции	role play
рай	paradise
райо́н	area
ра́ковина	sink
ра́нний	early
ра́ньше	before
ра́ньше	before, earlier
распина́ть / распя́ть	to crucify (кого)
распознава́ть / распозна́ть	to recognize, identify, discern (кого-что)
расстоя́ние	distance
расти́ / вы́расти	to grow
расти́тельное ма́сло	vegetable oil
расчёска	comb
рвать / вы́рвать	to vomit (от чего)
ребёнок	child, infant, kid
ре́зать / поре́зать	to cut (что)
река́	river
рекоменда́ция	recommend
религио́зный	religious
рели́гия	religion
рентге́н	X-ray
репети́ция хо́ра	choir practice
рестора́н	restaurant
реформа́тор	Reformer
реформи́ровать	to reform (что)
реце́пт	prescription
речь	speech
реша́ть / реши́ть	to decide (что)
реше́ние	decision
рис	rice
роди́вшийся	born
роди́тельный паде́ж	genitive case
родно́й го́род	hometown
ро́дственник	relative
рожда́ться / роди́ться	to be born
рожде́ние	birth
Рождество́	Christmas
ро́за	rose
рома́шка	daisy
руба́шка	shirt
рука́	arm, hand
рука́в	sleeve
ру́ки	hands
руководи́тель	leader
руководи́тель миссионе́рской де́ятельности	ward mission leader
руководи́ть / поруководи́ть	to lead, to guide, to direct (кем-чем)
руково́дство	guidance
рукоположе́ние	setting apart
румя́на	blush
руче́й	stream
ру́чка	pen
ры́ба	fish
рюкза́к	backpack
С Но́вым Го́дом	Happy New Year
сад	garden
сала́т	salad
сала́т-лату́к	lettuce
сало́н	salon
самолёт	airplane
санда́ли	sandals
сатана́	Satan
са́хар	sugar
сва́дьба	wedding
свёкор	father-in-law (husband's father)
свекро́вь	mother-in-law (husband's mother)
свет	light
светофо́р	stop light
свиде́тель	witness (person)
свиде́тель Иего́вы	Jehovah's Witness
свиде́тельство	testimony, testament, witness
свиде́тельствовать / засвиде́тельствовать	to testify, to witness (о ком-чём)
свини́на	pork
свинья́	pig
сви́тер	sweater
свобо́да	freedom
свобо́да вы́бора	agency, freedom of choice
свобо́дное вре́мя	free time
свобо́дный	free
сво́дная сестра́	step-sister
сво́дный брат	step-brother
свя́зываться / связа́ться	to contact (с кем-чем)
свято́й	holy, sacred, saint
Свято́й	saint
Свято́й Дух	Holy Ghost
Свято́й после́дних дней	Latter-day Saint
Свяще́нная ро́ща	Sacred Grove
свяще́нник	priest, minister
Свяще́нные Писа́ния	(Holy) Scriptures
свяще́нный	sacred, holy
свяще́нство	priesthood
Свяще́нство Ааро́ново	Aaronic Priesthood
Свяще́нство Мелхиседе́ково	Melchizedek Priesthood
сгиба́ть / согну́ть	to bend (что)
се́вер	North
Се́верная Аме́рика	North America
се́веро-восто́к	northeast
се́веро-за́пад	northwest
сего́дня	today
седьмо́й	seventh
секрета́рь	secretary
семе́йная исто́рия	family history
семидеся́тый	seventieth
семна́дцатый	seventeenth
семна́дцать	seventeen
семь	seven
се́мьдесят	seventy
семья́	family
сентя́брь	September
се́рдце	heart
се́рый	grey
се́рьги	earrings
серьёзный	serious
сестра́	sister
сестра́	Sister
сиде́ть / сесть	to sit (за чем)(на чём)(с кем-чем)
си́ла	strength, power
сильне́е	stronger
си́льный	strong, powerful
си́мвол	symbol
симпто́м	symptom
си́ний	blue
склоне́ние	declension
склоня́ть / склони́ть	to decline (что)
склоня́ться / склони́ться	to be declined
сковорода́	pan
ско́лько	how much, how many (кого-чего)
скорбь	sorrow
скри́пка	violin
скро́мный	modest
слабе́е	weaker
сла́бый	weak
сла́ва	glory
сле́довать / после́довать	to follow (кому-чему)(за кем-чем)
сле́дующий	next, following
слова́рь	dictionary
сло́во	word
Сло́во Му́дрости	Word of Wisdom
сло́жный	difficult (synonymous to трудный and тяжёлый)
слон	elephant
слуга́	servant
слу́жащий	employee
служе́ние	service, ministry
служи́ть / послужи́ть	to serve (кому-чему)
слух	hearing
случа́ться / случи́ться	to happen (с кем)
слу́шатель	investigator
слу́шать / послу́шать	to listen (кого-что)
слу́шаться / послу́шаться	to obey (кого-чего)
слы́шать / услы́шать	to hear (кого-что)
сме́ртность	mortality
сме́ртный	mortal
смерть	death
смущённый	confused, embarrassed
смысл	purpose
снег	snow
снима́ть / снять	to take off (что)
сно́ва	again, anew
сня́тие со счёта	withdrawal
соба́ка	dog
собесе́дование	interview
собира́ться / собра́ться	to meet, gather (на, в чём)
собла́зн	temptation, enticement
соблюда́ть / соблюсти́	to keep (e.g. command-ments) (что)
собра́вшиеся	congregation
собра́ние	meeting
собра́ние о́круга	district meeting
собра́ние свиде́тельств	testimony meeting
со́бственный	personal, someone's own
соверша́ть / соверши́ть	to commit (a sin, crime, etc.) (что)
соверша́ть / соверши́ть	to commit (to do) (что)
соверша́ть / соверши́ть	to perform (что)
соверша́ть / соверши́ть та́инство	to administer an ordinance (что)
соверше́нный	perfect
соверше́нствоваться / усоверше́нствоваться	to progress (в ком-чём)
сове́т	council
сове́т	counsel
сове́тник	counselor
согреше́ние	transgression
содержа́ть	to contain (кого-что)
Соединённые Шта́ты	United States
создава́ть / созда́ть	to create, establish (кого-что)
сок	juice
со́лнечная пого́да	sunshine
со́лнце	sun
солнцезащи́тные очки́	sunglasses
соль	salt
сомне́ние	concern, doubt
сон	dream
сопротивле́ние	opposition
со́рок	forty
сороково́й	fortieth
сосе́д	neighbor
соси́ска	hot dog
сосна́	pine
состоя́ние	state, condition
со́тый	one hundredth
сохраня́ть / сохрани́ть	to preserve (что)
спаге́тти	spaghetti
спа́льня	bedroom
спасе́ние	salvation
Спаси́тель	Savior
спать / поспа́ть	to sleep (на, в чём)
специа́льность	major
спина́	back
споко́йный	calm
спорт	sports
спорти́вные штаны́	sweat pants
спорти́вный зал	gym
спра́шивать / спроси́ть	to ask (for information) (кого-что)(о ком-чём)
сра́внивать / сравни́ть	to compare (кого-что)(с кем-чем)
среда́	Wednesday
сре́днего разме́ра	medium size
сре́дний	medium
сре́дний род	neuter gender
стака́н	glass
станови́ться / стать	to become (кем-чем)
ста́нция	station
старе́йшина	Elder
ста́ршие кла́ссы	high school
ста́рый	old
сте́пень	degree
сте́пень Бакала́вра	Bachelor's degree
стира́ть / вы́стирать	to do laundry (что)
стих	verse
сто	one hundred
сто́ить	to cost
стол	table
столе́тие	century
столо́вая	cafeteria
столо́вая	dining room
стомато́лог	dentist
стопа́	foot
стоя́ть / постоя́ть	to stand
страда́ние	suffering, agony, anguish
страда́ть / пострада́ть	to suffer (от кого-чего)(из-за кого-чего)(за кого)
страна́	country
страни́ца	page
страх	fear
стреми́ться / устреми́ться	to strive (к кому-чему)
стро́ить / постро́ить	to build (что)(на чём)
студе́нт	student (higher education)
стул	chair
стуча́ть / постуча́ть по дверя́м	to tract (по чему)
суббо́та	Saturday
суд	court
суд	judgment
суди́ть	to judge (кого-что)
судья́	judge
су́мка	bag
су́мма	amount
суп	soup
супру́г	spouse
сухо́й за́втрак	cereal
су́ша	land
суши́лка	dryer
счастли́вый	happy
сча́стье	happiness
счёт	account
сын	son
Сын	Son
сыр	cheese
таба́к	tobacco
табле́тка	pill
та́инство	ordinance
такси́	taxi
тала́нт	talent
там	there
та́нцы	dancing
та́почки	slippers
тарака́н	cockroach
таре́лка	plate
твори́тельный паде́ж	instrumental case
твори́ть / сотвори́ть	to create, make, do (кого-что)
теа́тр	theater
телеви́зор	television
телестиа́льный	telestial
те́ло	body
темнота́	darkness, obscurity
температу́ра	temperature
те́ни	eye shadow
те́ннис	tennis
тёплый	warm
терпели́вый	patient
терпе́ние	patience
террестриа́льный	terrestrial
теря́ть / потеря́ть	to lose (кого-что)
тесть	father-in-law (wife's father)
тетра́дь	notebook
тётя	aunt
те́хникум	technical college
тёща	mother-in-law (wife's mother)
тигр	tiger
това́рищество	fellowship
толкова́ть / истолкова́ть	to interpret (что)
тона́льный крем	foundation (makeup)
торна́до	tornado
тост	toast
трава́	grass
тра́тить / потра́тить	to spend (что)(на что)
тре́бовать / потре́бовать	to require (что)(у кого)
тре́тий	third
три	three
тридца́тый	thirtieth
три́дцать	thirty
триллио́н	one trillion
триллио́нный	one trillionth
трина́дцатый	thirteenth
трина́дцать	thirteen
тротуа́р	sidewalk
труба́	trumpet
труд	labor
тру́дный	difficult (synonymous to тяжёлый and сложный)
тря́пка	rag
туале́т	restroom
туда́ и обра́тно	round trip
тума́н	fog
ту́фли	dress shoes
тушь для ресни́ц	mascara
ты	you (informal, singular)
ты́сяча	one thousand
ты́сячный	one thousandth
тьма	darkness
тюльпа́н	tulip
тяжёлый	difficult (synonymous to трудный and сложный)
у	at (кого-чего)
убира́ть / убра́ть	to clean, organize (что)
уваже́ние	respect, esteem
уве́ренность	confidence, assurance
увольня́ть / уво́лить	to fire (кого) (с чего)
угрызе́ние со́вести	remorse
удаля́ть / удали́ть	to pull, remove (кого-что)
удоста́иваться / удосто́иться	to become worthy (кого-чего)
удостовере́ние	certificate
уже́	already
у́жин	dinner, supper
у́зкий	tight
узнава́ть / узна́ть	to find out, recognize (кого-что)
Уи́льям Ти́ндал	William Tyndale
уко́л	shot
укрепля́ть / укрепи́ть	to strengthen (кого-что)
у́лица	street
ум	mind
умира́ть / умере́ть	to die (от чего)(за кого)
универма́г	mall
университе́т	university
уполномо́ченный	commissioned
употребля́ть / употреби́ть	to use (e.g. alcohol) (что)
управля́ть / упра́вить	to govern, to control (кем-чем)
урага́н	hurricane
уро́к	lesson
уси́лие	effort
усло́вие	condition
усоверше́нствованный	perfected
успе́х	success
уста́лый	tired
устрое́ние	dispensation
усыновлённый	adopted
утеша́ть / уте́шить	to comfort (кого)
утеше́ние	comfort
у́тка	duck
у́тро	morning
у́тром	in the morning
утю́г	iron
уха́живать / поуха́живать за ке́м-то	to care for someone
уходи́ть / уйти́ с рабо́ты	to quit the job (с чего)
уча́ствовать / поуча́ствовать	to participate (в чём)
уче́ние	teaching, doctrine
Уче́ние и Заве́ты	Doctrine and Covenants
учени́к	disciple
учени́к	student (K-12)
учёный	scientist
учи́тель	teacher
учи́ть / научи́ть	to teach (кого)(чему)
учи́ться / научи́ться	to learn, study (чему)(на кого)
февра́ль	February
физи́ческий	physical
фильм	movie
фиоле́товый	purple
фи́рма	firm
фле́йта	flute
фортепиа́но	piano
фотогра́фия	picture, photograph
фотоплёнка	film
фра́за	phrase
фру́кты	fruit
футбо́л	soccer
футбо́лка	t-shirt
хара́ктер	character
химчи́стка	dry cleaners
хлеб	bread
ходи́ть - идти́ / пойти́	to walk (по чему)
ходи́ть -идти́ / пойти́	to go by foot
холм	hill
холоди́льник	refrigerator
холо́дный	cold (adj.)
хор	choir
хоро́ший	good (adj.)
хоте́ть / захоте́ть знать	to wonder (кого-что)
храм	temple (n.)
хра́мовая рабо́та	temple work
хра́мовый	temple (adj.)
храни́ть / сохрани́ть	to keep, to preserve (кого-что)
христиани́н	Christian (n.)
христиа́нский	Christian (adj.)
Христо́с	Christ
ху́же	worse
ца́рство	kingdom
цвето́к	flower
целестиа́льный	celestial
целому́дрие	chastity
цель	goal
цена́	price
центр	center
центр го́рода	downtown
центр ко́ла	stake center
церемо́ния	ceremony
церко́вный	church (adj.)
це́рковь	church (n.)
чай	tea
час	hour
ча́сто	often
часы́	watch
ча́шка	tea cup
чек	check
челове́к	person
челове́чество	mankind
черда́к	attic
че́рез	across (кого-что)
че́рез	through (кого-что)
черепа́ха	turtle
чёрный	black
чесно́к	garlic
че́стный	honest
честь	honor
четве́рг	Thursday
четвёртый	fourth
четы́ре	four
четы́рнадцатый	fourteenth
четы́рнадцать	fourteen
чи́псы	potato chips
число́	number, date
чи́стить / почи́стить	to clean (что)
чи́стый	pure
чита́ть / проче́сть моли́тву	to offer a prayer (что)
чита́ть / прочита́ть	to read (что)
член вы́сшего сове́та	high councilor
член Це́ркви	member of the Church
чле́нство	membership
чтить / почти́ть	to honor, revere (кого-что)
что	what
чу́вство	feeling
чу́вствовать / почу́вствовать	to feel (кого-что)
чу́до	miracle
шампу́нь	shampoo
ша́пка	hat
шва́бра	mop
шестидеся́тый	sixtieth
шестна́дцатый	sixteenth
шестна́дцать	sixteen
шесто́й	sixth
шесть	six
шестьдеся́т	sixty
ше́я	neck
шкала́	scale
шкаф	closet
шка́фчик	cabinet
шко́ла	school
шко́льник	student, schoolboy
шнурки́	laces
шокола́д	chocolate
шо́рты	shorts
шоссе́	freeway
штаны́	pants
што́ры	curtains
ще́дрый	generous
щека́	cheek
щётка	brush
щётка для воло́с	hair brush
щи́пчики для ногте́й	nail clippers
экза́мен	exam
эле́ктрик	electrician
эта́ж	floor, story
ю́бка	skirt
юг	South
ю́го-восто́к	southeast
ю́го-за́пад	southwest
Ю́жная Аме́рика	South America
юри́ст	lawyer
я	I
я́блоко	apple
язы́к	tongue
я́йца	eggs
янва́рь	January
я́сно	clear
