(那)類型	that type (Nà lèixíng)
T恤衫	T-xùshān - T-shirt
一	(yī) one
一下	(yí xià) once; a bit
一乾二净一干二净	Yīgān èr jìng yīgān èr jìng - completely; thoroughly
一会儿	a little while (yíhuìr)
一共	(yí gòng) altogether
一号线	(yī hào xiàn) Line 1
一向	yíxiàng - all along; the whole time; constantly
一定	certain, definite; certainly, definitely (yídìng)
一带	yídài - the area around a particular place (the neighboring area)
一房一厅	(yī fáng yī tīng) one bedroom and one living room
一月	(yī yuè) January
一样	(yíyàng) same; alike
一次性	yícìxìng - one-time
一直	(yìzhí) straight; continuously
一般	(yì bān) normally, generally
一般	yì bān - normally, generally
一起	(yìqǐ) together
一路平安	(yí lù píng ān) to have a pleasant journey / bon voyage
一边	(Yībiān) simultaneously; at the same time
七	(qī) seven
七月	(qī yuè) July
丈夫	husband (zhàngfu)
三	(sān) three
三月	(sān yuè) March
上个	(shàng gè) the previous one
上午	(shàngwǔ) morning
上大学	(shàng dàxué) to attend college/university [vo.]
上次	last time (shàng cì)
上海	(Shàng hǎi) Shanghai
上海	Shanghai (Shànghǎi)
上班	shàng bān - to go to work; to be on duty; to start work; to go to the office
上瘾	to become addicted (shàng yǐn)
上网	(shàng wǎng) to go on the internet
上菜	to serve food (shàng cài)
上课	(Shàngkè) to go to class
上车	(shàng chē) to get on vehicle
下个	(xià ge) next one
下午	(xiàwǔ) afternoon
下次	(xià cì) next time
下车	(xià chē) to get off a bus, train, etc.
下车	(xià chē) to get off a bus, train, etc.
下载	xiàzài - to download
下雨	(xià yǔ ) to rain
下雪	(xià xuě) snowing
不	(bù) no; not
不仅	(bù jǐn) not only
不但。。。而且	not only... but also... (bú dàn ... ér qiě ...)
不停	bùtíng - continuously; incessantly
不同	bù tóng - different; not the same
不同的觀點	different point of view (Bùtóng de guāndiǎn)
不堪设想	Bùkānshèxiǎng - (of consequences) too ghastly to contemplate; unimaginable; extremely bad or dangerous
不好意思	(bùhǎo yìsi ) to feel embarrassed
不如	bùrú - not equal to; inferior to; to not measure up to
不得了	bù dé liǎo - extremely; exceedingly; couldn't be more
不必	búbì - need not; not have to
不断	bù duàn - continuously
不是。。。而是。。。	bú shì... ér shì - it is not... but
不用	(bú yòng) need not
不管	bù guǎn - no matter of, regardless of
不见得	（bú jiàn de）not necessarily
不见得	not necessarily (bú jiàn de)
不过	(búguò) however; but
不错	(búcuò) not bad; pretty good
与	yǔ - and, with
专业	(zhuān yè) specialist are of study, major in college
世界	world (shìjiè)
东	east (dōng)
东京	Tokyo (dōngjīng)
东西	(dōngxi) things; objects
两	(liǎng) two; a couple of
严重	yán zhòng - serious, severe, grave
个	(gè) a measure word for counting objects
中	(zhōng) medium; middle
中	Zhòng - to fit exactly; to hit
中介	(zhōngjiè) agent
中介	(Zhōngjiè) agent
中午	(zhōngwǔ) noon
中国	(Zhōng guó) China
中国城	Chinatown (Zhōngguóchéng)
中学	zhōngxué (middle school)
中心	(zhōngxīn) center
中间	(zhōng jiān) in the middle
为	(wèi) for
为了	(wèi le) in order to, for the sake of
为什么	(wèishénme) why
主意	zhǔyì (idea)
主要	zhǔ yào - main, principal
举	jǔ - to lift; to raise
久	(jiǔ) long (time)
之	Zhī - Literary counterpart of 的
之间	zhī jiān - between; among
乒乓球	pīng pāng qiú - table tennis; ping-pong
乖	guāi - (of children) obedient; well-behaved
九	(jiǔ) nine
九月	(jiǔ yuè) September
也	(yě) also, too
习惯	xí guàn - habit, to be accustomed to
书	(shū) book
书店	(shūdiàn) bookstore
书本	books (shūběn)
书架	bookshelf (shū jià)
书桌	desk (shūzhuō)
买	(mǎi) to buy
乱	(luàn) messy, chaotic
了	(a dynamic particle)
了解	liǎo jiě - to understand, know about
事（儿）	(shì)(r) matter; affair; event
事业	shìyè - career; undertaking
事情	shì qing - thing, matter, affair
二	(èr) two
二姐	(èrjiě) second eldest sister
二月	(èr yuè) February
于	yú - at, on, in, to, than
于是	yú shì - so, therefore
互相	(hù xiāng) mutually
互相	hù xiāng - mutual, each other, reciprocally
五	(wǔ) five
五月	(wǔ yuè) May
亚洲研究	(Yàzhōu yánji) Asian studies
些	(xiē) some; few; several; (a measure word)
交	jiāo - to hand over
交通	(jiāo tōng) traffic
交通	(jiāotōng) transportation; traffic
交通	jiāo tōng - traffic
交響樂	symphony (Jiāoxiǎngyuè)
享受	xiǎng shòu - enjoy; enjoyment; pleasure
亮	(liàng) bright; light; shine
亮	liàng - bright; light
亲眼	qīnyǎn - (to see) with one's own eyes
人	(rén) people; person
人口	Rénkǒu - population
人山	rén shān - huge crowds of people
人材	Réncái - person of ability, integrity, and talent
人民币	(rén mín bì) RMB Chinese currency
什么	(shén me) what
今天	(jīntiān) today
今年	(jīnnián) this year
介绍	(jiè shào) to introduce
从	from (cóng)
从...到...	(cóng...dào...) from...to...
从。。。到	(cóng...dào) From...to...
从不	(cóngbù) never
从来	(cóng lái) always, from the beginning
从来	cóng lái - from past till present; always; at all times; never (if used in negative sentence)
他	(tā) he; him
他们	(tāmen) they; them (for males)
付钱	(fùqián) to pay money
代	dài - to replace; to substitute
以	yǐ - with
以为	to assume erroneously (yǐwéi)
以前	(yǐ qián) before
以后	(yǐ hòu) after; from now on, later on
以来	yǐlái - since
件	(jiàn) measure word for shirt, dresses, jackets, coats, etc.
价格	price (jiàgé)
价钱	jià qian - price
份	(fèn) measure word for meal order, job
企业	qǐ yè - enterprise, business
休息	(xiū xi) rest, to take a break
会	(huì) can, to be able to
会	(huì) meeting
会	will (huì)
传统	chuán tǒng - tradition；convention
但是	(dànshì) but
位	(wèi) polite classifier for people
位子	seat (wèizi)
低	dī - low
住	to live (zhù)
体贴	tǐ tiē - show consideration for
余	yú - to surplus; to spare
你	(nǐ) you
你们	(nǐmen) - you (plural)
你好	(nǐ hǎo) Hello
使	shǐ - to make, cause, use
侄女	brother's daughter (zhí nǚ)
來不及	lái bu jí - not have enough time to do something; too late to do something
供	gōng - to provide; to support financially
便宜	(pián yi) cheap; inexpensive
保护	bǎo hù - protection, to protect, defend
保留	bǎoliú - to remain as before; to retain
保险	insurance (bǎoxiǎn)
信	(xìn) letter (correspondence)
信息	information (xìnxī)
信用卡	(xìnyòngkǎ) credit card
俩	(liǎ) two, both
倍	Bèi - (m.w. for times by which something is multiplied)
倒	dào - to turn upside down, to go backwards
借	jiè - to borrow; to lend
偏	
做	(zuò) to do
做法	zuòfǎ - way of doing things; course of action
做饭	(zuò fàn) to cook; to prepare a meal
健康	(jiàn kāng) health, healthy
健身	(Jiànshēn) to exercise
健身房	(jiànshēnfáng) gym
健身房	jiànshēnfáng - gym
偶尔	ǒu ěr - occasionally
傳統(的)	tradition/traditional (Chuántǒng de)
像	to be like; to look like; to take after (xiàng)
像	xiàng - such as
儿子	(érzi) son
儿童	ér tóng - children
元	Chinese currency unit (yuán)
元宵	Yuánxiāo - night of the fifteenth of the first lunar month; sweet dumplings made of glutinous rice flour
先	(xiān) first
先生	(xiān sheng) Mr; husband
免费	miǎn fèi - free (of charge)
全	quán - whole, entire, complete
八	(bā) eight
八月	(bā yuè) August
公共场所	gōnggòngchǎngsuǒ － public place
公共汽车	(gōng gòng qì chē) bus
公司	company (gōngsī)
公园	(gōng yuán) park
公园	park (gōngyuán)
公寓	apartment (gōngyù)
公平	(gōngpíng) fair; just; impartial; equitable
六	(liù) six
六月	(liù yuè) June
共同	(gòng tóng) common, together
关	guān - to close, shut, turn off
兴趣	interest (xìngqù)
其他	qí tā - other
其实	qí shí - actually, in fact
养	to raise (yǎng)
再	(zài) again
再	(zài) again
再见	(zài jiàn) goodbye
再说	moreover (zàishuō)
写	(xiě) to write
农历	nóng lì - lunar calendar (agricultural calendar)
农村	nóngcūn - countryside; village; rural area
冠军	(guànjūn) champion; first place in a competition
冬天	winter (dōngtiān)
冰	ice (bīng)
冰灯	bīngdēng - ice lantern
冰箱	(bīngxiāng) refrigerator
冰茶	(bīngchá) iced tea
决定	jué dìng - decision, to decide
冷	cold (lěng)
准	(zhǔn) to allow; to be allowed [v.]
准备	(zhǔnbèi) to prepare
减少	jiǎn shǎo - to lessen; to decrease; to reduce; to lower
减肥	jiǎn féi - to lose weight
减轻	jiǎn qīng - lighten / ease / alleviate
几	(jǐ) how much; how many; several; a few
几乎	jī hū - almost, nearly
出发	chū fā - departure, to start off, leave
出汗	chū hàn － to sweat
出版	chūbǎn - to publish
出现	chū xiàn - to appear
出生	(chū shēng) to be born
出生	（chū shēng）to be born
出租	(chūzū) to rent out
出租汽车	(chū zū qì chē) taxi
出门	Chū mén: To go out; to leave home
分	(fēn) cent; minute
分享	fēn xiǎng - to share (joys, benefits, privileges etc) with others
分别	respectively, separately (fēnbié)
分手	fēn shǒu - to break up; to part company
分钟	(fēn zhōng) minute
分钟	(fēnzhōng) minute
分钟	minute (fēnzhōng)
刚	(gāng) just; not long
刚	just (gāng)
刚才	just now, a moment ago (gāngcái)
初	(chū) beginning
初	chū - first
利息	lì xī - interest (on investment)
利用	lìyòng - make use of; take advantage of; to utilize
别	(bié) don't
别人	(bié rén) other people; another person
别的	(biéde) other
到	(dào) to go to; to arrive
到处	dào chù - everywhere, all over
到底	what on earth; what in the world; in the end (dàodǐ)
刷卡	(shuākǎ) to pay with a credit card
刻	（kè) quarter (of an hour)
前	(qián) forward; ahead
前	(qián) forward; ahead
前	(qián) forward; ahead
前面	(qián miàn) in front of
剛	just; recent (Gāng kāishǐ)
剛開始	just started; just began (Gāng kāishǐ)
剩（下）	shèng (xia) - to leave a surplus; to be left (over)
剩余	(shèngyú) to be left over; surplus
力气	(lìqi) strength/effort
劝	quàn - to persuade; to advise; to urge
办	(bàn) to handle; to do
办公室	(bàngōngshì) office
办法	(bàn fǎ) method, way of doing something
功课	(gōng kè) schoolwork
加	jiā - to add
加州	(jiā zhōu) California
加州	California (Jiāzhōu)
加油	jiāyóu － to make an extra effort；to refuel
加班	(jiā bān) to work overtime; to work extra shifts
动作	dòng zuò - action, movement, to make a move
包	(bāo) bag
包括	bāo kuò - to comprise; to include; to involve; to incorporate; to consist of
化学	(huàxué) chemistry
化学	chemistry (huàxué)
北	(běi) north
北京	(Běijīng) Beijing
医生	(yī shēng) doctor
医院	(yī yuàn) hospital
医院	(yīyuàn) hospital
医院	hospital (yīyuàn)
十	(shí) ten
十一月	(shí yī yuè) November
十二月	(shí èr yuè) December
十分	shí fēn - very
十月	(shí yuè) October
千万	qiān wàn - by all means; absolutely must
午饭	(wǔfàn) lunch
半	(bàn) half; half an hour
半天	(bàntiān) half of the day; a long time; quite a while
单位	unit (dānwèi)
单程	(dānchéng) one-way trip [n.]
卖完	(màiwán) to be sold out
南	(nán) south
南京	Nánjīng - Nanjing
博士	bó shì - PhD, doctor
博客	blog (bókè)
博物館	museum (Bówùguǎn)
博物馆	bówùguǎn - museum
卡	(kǎ) card
卡拉OK	kǎlā OK -- karaoke
卧室	bedroom (wòshì)
卧铺	wòpù - sleeping berth or bunk on a train
卫生纸	wèi shēng zhǐ - toilet paper
卫生间	(wèishēngjiān) bathroom
印象	(yìnxiàng) impression
印象	impression (yìnxiàng)
危机	crisis (wēijī)
危险	(wēi xiǎn) danger; dangerous
即使	(jíshǐ) even if
即使	jí shǐ - even if, even though
历史	(lì shǐ) history
历史	history (lìshǐ)
厉害	terrible ; formidable (lìhai)
压	(yā) to press; to hold down; to weigh down [v.]
压力	yā lì - pressure, stress
厕所	(cè suǒ) toilet
原因	(Yuányīn) reason
原来	yuán lái - as a matter of fact; formerly, original
厦	shà - mansion; tall building
厨房	kitchen (chúfáng)
去	(qù) to go
去年	last year (qùnián)
参加	cān jiā - to participate; to take part; to join
又	again (yòu)
双	(shuāng) Measure word for a pair
反对	fǎn duì - opposition, to oppose
发烧	(fāshāo) to have a fever
发生	fā shēng - to happen, occur
发电	fādiàn － to generate electricity
发短信	(fāduǎnxìn) to send a text message; (lit.) to send a short message
发财	fā cái - to get rich; to make a fortune
发音	(fā yīn) pronunciation
取之不尽	qǔ zhī bú jìn - (of resources) inexhaustible
取得	qǔ dé - to acquire / to get / to obtain
受不了	shòu bu liǎo - unbearable, can't stand it
受到	shòu dào - to receive (abstract; help, assistance, education, etc.)
变	biàn - to change
变化	biàn huà - change; to change
口	(kǒu) (mouth) measure word for number of family members
口味	taste; dietary preference (kǒuwèi)
口水	saliva (kǒu shuǐ)
古老	gǔlǎo - ancient; old
句	jù (measure word for sentences)
另外	(lìng wài) another, furthermore
只	(zhǐ) only
只	zhī - m.w. for one of certain paired things and some animals
只好	zhǐhǎo - have to; be forced to
只要	zhǐyào - if only; so long as
叫	(jiào) to be called
叫	jiào - to make (someone do something)
叫（菜）	jiào (cài) - to order (food)
可乐	(kělè) (Coke or Pepsi) cola
可以	(kěyǐ) can; may
可是	(kěshì) but
可爱	cute, lovable (kě ài)
可能	(kě néng) possible, maybe
可见	kějiàn - it is obvious that; it can be seen that
可靠	kě kào - reliable
台	tái - measure word for machines, table
台北	Taipei (táiběi)
右	right (yòu)
号	(hào) measure word for number in a series; day of the month
号	(hào) size
号码	number (hàomǎ)
吃	(chī) to eat
吃坏	to get sick because of bad food (chī huài)
各	gè - each; every
合	Hé - to combine; to join
合同	hétong - contract; agreement
合适	(hé shì) suitable
同	(tóng) same, together
同事	(tóngshì) colleague; co-worker
同学	(tóngxué) classmate
同屋	roommate (tóng wū)
同工同酬	tóng gōng tóng chóu - equal pay for equal work
同意	tóng yì - to agree; to consent; to approve
名字	(míng zi) name
名牌儿	name brand (mínpáir)
后天	the day after tomorrow (hòutiān)
后来	(hòu lái) later, afterwards
后果	hòu guǒ - consequence
吗	(ma) question particle
否则	fǒu zé - otherwise, or else
听	(tīng) to listen
听说	(tīngshuō) to be told; to hear of
吵	(chǎo) noisy, to quarrel
吵架	chǎo jià - to quarrel
吸引	(xī yǐn) to attract, draw, interest
吸烟	xī yān - to smoke a cigarette
吹	chuī - to end a relationship; (lit.) to blow
呀	(interjectory particle used to soften a question)
告诉	(gào su) to tell
呢	(ne) question particle
周末	(zhōumò) weekend
味道	wèi dào - taste, flavour
和	(hé) and
咕噜	gūlū - rumbling sound
咖哩	curry (Gālí)
咖啡	(kāfēi) coffee
咖啡色	(kāfēi sè) brown; coffee color
咱们	zán men - we, us
咸	salty (xián)
哈	hā - (imitating laughter)
哎	(āi) exclamatory particle to express surpise or dissatisfaction
哎呀	(an exclamation to express surprise) gosh; ah （āiyā）
哥哥	(gēge) older brother
哪	(nǎ/něi) which
哪儿	(nǎr) where
哪里	(nǎ li) Where
哪里	(nǎlǐ) where
哭	(kū) to cry
哲学	philosophy (zhéxué)
售货员	(shòuhuòyuán) shop assistant; salesclerk
唱	(chàng) to sing
唱歌	(chàng gē) to sing (a song)
商场	(shāng chǎng) shopping mall
商店	(shāng diàn) store, shop
啊	(a) a sentence-final particle of exclamation, interrogation
啊	a - eh?; what? (a sentence-final particle of exclamation, interrogation, etc.)
喂	(wéi/wèi) Hello!; Hey! (When talking on a telephone)
喜欢	(xǐhuān) to like
喝	(hē) to drink
嘛	particle used to emphasize the obvious (ma)
嘴	mouth (zuǐ)
噢	oh! (ō)
四	(sì) four
四季如春	sìjì rú chūn - spring-like all year round
四月	(sì yuè) April
回	(huí) to return
回	huí - measure word for frequency of an action
回去	(huí qu) to go back; to return
回家	(huí jiā) to go home
回收	huíshōu － recycle
回来	(huí lai) to come back
因为	(yīnwèi) because
团	tuán - group, organization
团圆	tuányuán - to reunite (as a family)
国家	guó jiā - country; nation
国际	international (guójì)
图书馆	(túshūguǎn) library
圆	round (yuán)
圈	Quān: Circle; to encircle; to mark with a circle
在	(zài) at, in, on
在	(zài) to be present; to be at (a place)
在乎	zàihu - to mind, to care
地位	position, status (dìwèi)
地图	map (dìtú)
地形	dìxíng - terrain; topography
地方	place (dìfang)
地球	Dìqiú - the earth; the globe 🌏
地理	dì lǐ - geography
地道	dì dào - original, genuine, authentic
地铁	(dì tiě) subway
地铁	(dì tiě) subway
场	field (chǎng)
坐	(zuò) to sit
坐	(zuò) to sit
坐	(zuò) to travel by
坐船	(Zuò chuán) to travel by ship; to take a boat
块	(kuài) measure word for the basic Chinese monetary unit
垃圾	lājī - garbage; trash
城市	(chéngshì) city
報告	report (a written report) (Bàogào)
塑料袋	(sùliàodài) plastic bag
塔	Tǎ - tower, pagoda-shaped structure
墙	qiáng - wall
增加	zēng jiā - increase
声音	shēng yīn - voice, sound
复习	(fùxí) to review
夏天	summer (xiàtiān)
外卖	takeout (wàimài)
外国	(wàiguó) foreign country
多	(duō) how much/many
多	(duō) many; much
多少	(duōshao) how much/many
夜里	at night (yèli)
够	(gòu) enough
够	enough (gòu)
大	(dà) big; old
大人	Dàrén - adult
大哥	(dàgē) eldest brother
大多	dàduō - mostly; for the most part
大姐	(dàjiě) eldest sister
大学	(dàxué) university; college
大学生	(dàxuéshēng) college student
大家	(dà jiā) everyone
大小	(dàxiǎo) size
大概	(dà gài) probably, approximately
大概	(dàgài) probably; around; about
大男子主义	(dà nánzǐ zhǔyì) male chauvinism
天	(tiān) day
天气	weather (tiānqì)
太太	(tài tai) wife
太好了	(tài hǎo le) That's great!
太极	(tài jí) Tai Chi
太极拳	tàijíquán - taichi
太阳	tài yáng - sun
太阳能	tàiyángnéng － solar energy
夫妻	Fūqī - husband and wife; couple
奇怪	qí guài - strange
奖学金	jiǎngxuéjīn - scholarship money
套	(tào) measure word for house, apartment, etc.
套	measure word for suite or set (tào)
女	(nǚ) female
女儿	(nǚ ér) daughter
女性	Nǚxìng - female
她	(tā) she; her
她们	(tāmen) they; them (for females)
好	(hǎo) very
好久	(hǎojiǔ) a long time
好像	(hǎoxiàng) to seem; to be like
好几	(hǎojǐ) quite a few
好吃	( hǎo chī ) delicious (food)
好处	(hǎochu) advantage, benefit
好处	advantage; benefit (hǎochù)
好玩儿	(hǎowánr) fun, amusing, interesting
好看	hǎokàn - nice-looking; attractive
如果...的话

rúguǒ...de huà	(rúguǒ...de huà) if...then
妇女	fù nǚ - woman
妈妈	(māma) mom, mother
妹妹	(mèimei) younger sister
妻子	qīzi - wife
妻管严	(qī guǎn yán) wife controls (her husband) strictly
姐妹	(jiě mèi) sisters; female friends or co-workers who share a sister-like bond
姐姐	(jiějie) older sister
姑妈	gūmā - father's sister
姓	(xìng) surname
嫂子	sǎozi - older brother's wife
嫌	Xián - to dislike; to mind; to complain of
嫩	tender (nèn)
字	(zì) Character
存	cún - to save up
存款	cúnkuǎn - bank savings
孙女	(sūn nǚ) granddaughter; son's daughter
孙子	sūn zi - grandson; son's son
学习	(xué xí) to study, learn
学位	xuéwèi - (academic) degree
学分	xuéfēn - academic credit
学期	(Xuéqí) school term; semester/quarter
学校	(xuéxiào) school
学生	(xué sheng) student
孩子	(hái zi) child
它	(tā) it
安全	(ān quán) safe
安全	（ān quán）safe
安排	ān pái - arrangement, to set up
安静	quiet (ān jìng)
完	(wán) finished
完全	wán quán - complete, whole, totally, entirely
实习	(shí xí) to intern
实际上	shíjìshang - in fact; in reality; actually
宠物	pet (chǒngwù)
客厅	living room (kètīng)
客戶經理	Account Manager (Kèhù jīnglǐ)
客气	(kèqi) polite
害	hài - to cause trouble; to do harm
家	(jiā) family, home
家	jiā - MW for families and commercial establishments
家乡	jiā xiāng - hometown
家具	furniture (jiājù)
家务	household chores； household duties (jiā wù)
家常	home-style (jiācháng)
家庭	jiā tíng - family (unit) / household
家教	jiājiào - tutor
家长	parents; guardian of a child (jiāzhǎng)
容易	(róng yì) easy; simple
宿舍	(sùshè) dormitory
寄電子郵件	to semd email (Jì diànzǐ yóujiàn)
寒假	(hán jià) winter vacation
对	(duì) correct
对不起	(duìbuqǐ) sorry
对面	duì miàn - opposite side
导游	(dǎo yóu) tour guide
封	(fēng) measure word for letters
将来	future (jiānglái)
尊重	zūnzhòng - to respect
小	(xiǎo) small
小区	(xiǎo qū) community
小区	(xiǎo qū) community
小区	xiǎo qū - residential complex
小吃	xiǎochī - small and inexpensive dishes; snacks
小姐	(xiǎo jiě) Miss
小学	xiǎoxué - elementary school
小心	(xiǎoxīn) to be careful
小时	hour (xiǎoshí)
小白菜	(xiǎobáicài) baby bok choy
少数	small number; few; minority (shǎoshù)
尝	cháng - to taste
就	(jiù) just, only
就	(jiù) precisely; exactly
尽可能	jǐn kěnéng - as much as possible; to the best of one's ability
层	céng - measure word for floors of a building
屋子	room (wūzi)
山	Shān - mountain
岁	(suì) year (of age)
工作	(gōngzuò) to work; job
工厂	gōng chǎng - factory
工商管理	(gōngshāng guǎnlǐ) business management
工资	gōng zī - wages, pay
左	left (zuǒ)
差不多	(chà bu duō) almost, nearly, just about right
已经	(yǐ jīng) already
巴西	bā xī - Brazil
市场	shì chǎng - market
帅	(shuài) handsome
师傅	(shī fu) master worker
希望	(xī wàng) to hope, wish
带	(dài) to bring
帮	(bāng) to help
帮助	to help (bāngzhù)
帮忙	（bāng máng）to help
帮忙	(bāngmáng) to help
常常	(chángcháng) often
帽子	(mào zi) hat
干净	clean (gānjìng)
干杯	gān bēi - to drink a toast, cheers
平原	píngyuán - plain
平常	(píngcháng) usually
平等	Píngděng - equality; equal
年	(nián) year
年夜饭	nián yè fàn - Chinese New Year's Eve dinner
年级	(nián jí) grade in school
并	bìng - actually; definitely
幸福	(xìng fú) happiness; happy
幸福	xìng fú - blessed; happiness; happy
幽默	(yōu mò) humorous; humor
幽默	yōu mò - humorous
广告	(guǎnggào) advertisement
广场	(guǎng chǎng) public square
广场	（guǎngchǎng) public square
床	(chuáng) bed
应该	(yīng gāi) should; ought to; must
度	dù - m.w. for degree of temperature, heat, humidity
座	zuò - (measure word for buildings and mountains)
建筑	architecture; to build (jiànzhù)
建议	jiàn yì - to suggest; suggestion
开	(kāi) to open; to hold (a meeting, party, etc.)
开会	(kāi huì) to have a meeting
开始	(kāi shǐ) to start
开学	(kāixué) to begin a new semester
开学	to begin a new semester (kāi xué)
开朗	kāi lǎnɡ - extroverted; open and sunny in disposition
开玩笑	(kāi wán xiào) to joke
开玩笑	kāi wán xiào - to play a joke; to make fun of; to joke
开车	(kāi chē) to drive a car
弓	bow (gōng)
弓	bow (gōng)
引起	yǐn qǐ - to give rise to; to lead to; to cause; to arouse
弟弟	(dìdi) younger brother
张	(zhāng) Measure word (flat object, paper, pictures, etc.)
当	(dāng) to serve as; to be
当然	(dāng rán) of course
录音	(Lùyīn) sound recording; to record
影	(yǐng) shadow
影响	yǐng xiǎng - effect, influence
往	(wǎng) towards
往	(wǎng) towards
往	(wǎng) towards
往返	(wǎngfǎn) make a round trip; go there and back
待	to stay (dāi)
很	(hěn) very
很好	(hěn hǎo) very good
很少	(hěn shǎo) seldom/very few
律师	(lǜshī) lawyer
得	(Dé) must; to have to
得	(děi) must; to have to
得病	dé bìng - to fall ill; to contract a disease
心	(xīn) heart; mind
心事	something weighing on one's mind (xīnshì)
心情	mood (xīnqíng)
必须	bìxū - must, have to
忘	to forget (wàng)
忙	(máng) busy
快	(kuài) fast; quick
快乐	(kuài lè) happy
快餐	kuài cān - fast food; quick meal
念	(niàn) to read aloud
态度	tài du - manner, attitude
怎么	(zěn me) how, why
怎么样	(zěnmeyàng) Is it O.K.? How is that? How does that sound?
怕	(pà) to be afraid; to fear
思考	sī kǎo - ponder over; think deeply; contemplation
急忙	jímáng - hastily; in a hurry
性格	(xìng gé) personality, character
性格	xìng gé - personality, character
总	zǒng - always
总之	zǒng zhī - in a word / in short / in brief
恐怕	(kǒng pà) fear; to dread; I'm afraid that...; perhaps; maybe
恭喜	gōngxǐ - to congratulate
您	(nín) You (polite, as opposed to informal 你 nǐ)
情况	qíng kuàng - circumstances, situation, condition
想	(xiǎng) to want to; would like to; to think
想	(xiǎng) to want to; would like to; to think
想法	(xiǎng fǎ) idea, opinion
想象	xiǎng xiàng - to imagine; to visualize; imagination
想起来	(xiǎng qi lai) to remember; to recall
意大利	Yìdàlì - Italy
意思	(yìsī) meaning
意思	yìsi - meaning
意见	yì jiàn - idea, opinion
感冒	(gǎnmào) to have a cold
感动	(gǎn dòng) to move someone emotionally
感情	gǎn qíng - emotion, feeling, affection
感觉	gǎn jué - to feel; sense perception; to preceive
愿意	(yuànyì) to be willing
慢	(màn) slow
懂	(dǒng) to understand
懒	lazy (lǎn)
成	to become (chéng)
成	town; city (chéng)
成为	chéng wéi - to become, to turn into
成功	chéng gōng - success, to succeed
成绩	chéng jì - grade, score, achievement
我	(wǒ) I; me
我们	(wǒmen) we; us
或者	(huò zhě) or
房东	Fángdōng: Landlord or landlady
房子	(fáng zi) house; apartment
房租	rent (fángzū)
房间	room (fángjiān)
所以	(suǒyǐ) so
手	hand (shǒu)
手机	(shǒujī) cell phone
才	(cái) not until; only then
打	(dǎ) to hit
打交道	to deal with (dǎ jiāodào)
打呼噜	dǎ hūlu - to snore
打工	(dǎ gōng) to work at a temporary job (often part time)
打扫	(dǎ sǎo) to clean; to sweep
打折	(dǎ zhé) to give a discount
打球	(dǎ qiú) to play ball
打电话	(dǎ diànhuà) to make a phone call
打算	(dǎ suàn) to plan
打车	(dǎ chē) to take a taxi
打车	(dǎ chē) to take a taxi
打针	(dǎ zhēn) to give or have an injection
扔	rēng - to throw, throw away
托运	to check (luggage) (tuōyùn)
找	(zhǎo) to look for
找資料	Search (Zhǎo zīliào)
找钱	(zhǎoqián) to give change
把	(bǎ ) indicating a thing is disposed of
把	(bǎ ) measure word for things with handles
投资	tóu zī - investment; to invest
护照	passport (hùzhào)
报名	bào míng - to sign up; to enter one's name; to apply; to register; to enroll; to enlist
报纸	newspaper (bàozhǐ)
抱	(bào) to hold; to carry (in one's arms); to hug or embrace; surround; cherish
抱怨	bàoyuàn - to complain
抵押	to mortgage (dǐ yā)
押金	(yājīn) security deposit [n.]
担心	(dān xīn) worried, to worry
拉	(là) (colloq.) to leave (something) behind
拉	pull
拍	(pāi) racket
拍	pāi - to take pictures; to shoot film; to clap; to pat
拍照	to take pictures (pāizhào)
拐	to turn (guǎi)
拜年	bàinián - to wish somebody a happy Chinese New Year; to pay a Chinese New Year's call
拥抱	yōng bào - to embrace; to hug; to hold in one's arms
拿	(ná) to take, to get
挂	guà - hang, hang up
指导	zhǐdǎo - to guide; guidance
挣钱	to earn money; to make money (zhèng qián)
挤	jǐ - crowded; to push against; to squeeze
挺	(tǐng) very; rather
挺...的	(Tǐng...de) quite; pretty
挺。。。的	(tǐng...de) quite
换	(huàn) to change, exchange
排	(pái) row, rank, line
接	(jiē) to meet, pick someone up
接受	(jiēshòu) to accept; to take on; to undertake
接着	jiēzhe - to follow; to continue
接近	jiē jìn - close to, near to
推	tuī - to push
提	tí - to mention; to bring up
提高	(tí gāo) improve, increase, raise the level of
搬	to move (bān)
搬家	(bān jiā) to move (one's residence)
搬家	（bān jiā）to move (one's residence)
摄氏	(Shèshì) Celsius; centigrade
摆	(bǎi) put, place; display; swing, sway
攒	zǎn - to accumulate; to hoard; to save; to scrape together
攝影	photography (Shèyǐng)
收	(shōu) to receive; to accept
收入	income (shōurù)
收電子郵件	to receive email (Shōu diànzǐ yóujiàn)
改革开放	gǎigékāifàng - to reform and open up
放	(fàng) to put; to place; to let out
放假	(fàng jià) to have a holiday or vacation
政府	government (zhèngfǔ)
政府	government (zhèngfǔ)
政治	(zhèngzhì) politics
政治	politics (Zhèngzhì)
故事	gù shi - story; tale
教	(jiāo) to teach
教室	(jiào shì) classroom
教授	professor (jiàoshòu)
教育	jiào yù - education
敢	gǎn - to dare
散步	sàn bù - to take a walk
数字	shù zì - number; figure; digit
数学	(shùxué) mathematics
整天	zhěng tiān - all day long
整理	(zhěng lǐ) to arrange, tidy up, sort out
文具	wén jù - stationery
文化	culture (wénhuà)
文化博物館	cultural museum (Wénhuà bówùguǎn)
文学	literature (wénxué)
文章	wén zhāng - article, essay
新	(xīn) new
新年	(xīnnián) new year
新生	(xīnshēng) new student
新生	new student (xīn shēng)
新聞	news (Xīnwén)
新闻	news (xīnwén)
新鲜	xīnxiān - fresh
方便	(fāngbiàn) convenient
方便	(fāngbiàn) convenient
方式	way; method (fāng shì)
方面	fāng miàn - side, aspect, respect
旁边	(pángbiān) next to, beside
旁边	(pángbiān) next to; beside
旁边	(pángbiān) side
旅客	lǚkè - passenger; voyager; traveler
旅游	lǚ yóu - to travel
旅行	to travel (lǚxíng)
旅馆	hotel (lǚguǎn)
无论	wú lùn - regardless of, no matter what
日	(rì) day; the sun
日本	(Rì běn) Japan
日用品	rì yòng pǐn - Daily Necessities
日记	(rì jì) diary
旧	jiù - old
早	(zǎo) morning, early
早上	(zǎoshang) early morning
早晨	early morning (zǎochén)
早饭	(zǎofàn) breakfast
时代	era; age (shídài)
时候	(shíhou) time; moment (duration of time)
时间	(shíjiān) time
时髦	shí máo - fashionable, stylish
明天	(míngtiān) tomorrow
星星	(xīngxing) star
星期	(xīngqī) week
星期一	(xīng qī yī) Monday
星期三	(xīng qī sān) Wednesday
星期二	(xīng qī èr) Tuesday
星期五	(xīng qī wǔ) Friday
星期六	(xīng qī liù) Saturday
星期四	(xīng qī sì) Thursday
星期日	(xīng qī rì) Sunday
春天	spring (chūntiān)
昨天	(zuótiān) yesterday
是	(shì) to be
显得	to appear (to be); to seem (xiǎn de)
晚	(wǎn) late; evening
晚上	(wǎnshang) evening; night
晚会	wǎnhuì - evening party
晚饭	(wǎnfàn) dinner; supper
景点	jǐngdiǎn - scenic spot; tourist spot
暑假	(shǔjià) summer vacation
暑期	summer term (shǔqī)
暖和	(nuǎnhuo) warm; nice and warm
暖气	Nuǎnqì - central heating
更	even more (gèng)
最	most (zuì)
最后	(zuì hòu) final; last
最好	(zuì hǎo) had better
最好	(zuì hǎo) had better [adv.]
最近	(zuì jìn) recently
月	(yuè) month
月饼	yuè bǐng - mooncakes
有	(yǒu) to have
有名	(yǒumíng) famous; well-known
有意思	(yǒu yìsi) interesting
有时候	(yǒu shí hou) sometimes
有用	yǒuyòng - useful
有的	(yǒude) some
有益	yǒuyì - beneficial; useful
朋友	(péngyou) friend
服务	(fúwù) to serve, to provide service
服务员	(fúwùyuán) waiter, waitress
服装	Fúzhuāng - clothing; apparel
望女成风	wàng nǚ chéng fèng - to hope that one's daughter will become a phoenix; to hope that one's daughter will become successful
望子成龙	wàng zǐ chéng lóng - hope for one's son to be successful；to hope that one's son will become a dragon
未婚妻	wèihūnqī - fiancée
末	mò - end
本	(běn) measure word for books
本来	běn lái - originally, at first
机会	jī huì - chance, opportunity
杂志	magazine (zázhì)
李	(Lǐ) Li
条	(tiáo) measure word for pants and long, thin objects
条件	tiáo jiàn - requirements, conditions
来	(lái) to come
来往	Lái wǎng: To come and go; to have dealings with
杯	(bēi) (measure word for cup and glass) cup of; glass of
极	(jí) extremely
枕头	zhěntou - pillow
枝	(zhī) Measure word (long, thin, inflexible, objects such as pens, rifles, etc.)
某	mǒu - certain, some
柜子	guìzi - cabinet, cupboard
查	(chá) to check; to look up
标准	biāo zhǔn - standard, requirement
栋	dòng - measure word for buildings
树	shù - tree
树林	shùlín - woods; forest
校内	on campus (xiào nèi)
校内	on campus (xiào nèi)
校外	off campus (xiào wài)
校外	off campus (xiào wài)
样子	(yàngzi) style
根本	gēn běn (not) at all / simply / fundamental / basic / root
桌子	(zhuō zi) table
梨	pear (lí)
检查	(jiǎnchá) to examine
棒	(bàng) fantastic; super (colloquial; Northener)
椅子	chair (yǐzi)
楼	(lóu) building; floor
楼	(lóu) floor, multi-storey building
楼	(lóu) floor, multi-storey building
模范	(mófàn) exemplary; model; fine example
橘红色	(júhóngsè) orange
欠	qiàn - to owe
次	(cì) number of times (measure word)
歌	(gē) song
正在	(zhèng zài) in the middle of (doing something)
正好	zhèng hǎo - coincidentally
正式	zhèng shì - formal, official
正月	Zhēngyuè - first month of the lunar year; first moon
歷史博物館	history museum (Lìshǐ bówùguǎn)
段	duàn - paragraph; section; segment; stage (of a process); classifier for stories, periods of time, lengths of thread etc
每	(měi) every; each
比	comparison marker (to compare) (bǐ)
比分	bǐfēn - score
比如	bǐ rú for example; for instance; such as
比赛	(bǐ sài) competition, contest, match
比较	(bǐ jiào) relatively, comparatively
比较	（bǐ jiào）relatively, comparatively
毕业	bì yè - graduation, to finish school
毕竟	(bìjìng) after all; all in all; in the final analysis; when all is said and done
毛	(máo) measure word for 1/10 of a kuai, dime (US money)
毛巾	máo jīn - towel
毛衣	máoyī - sweater
毯子	blanket (tǎn zi)
民以食为天	mín yǐ shí wéi tiān - the people think of food as important as heaven
民族	mín zú - nationality, ethnic group
气氛	qì fēn - atmosphere; ambiance; mood
水	(shuǐ) water
水平	(shuǐ píng) level, standard
水果	fruit (shuǐguǒ)
汉字	(hàn zì) Chinese characters
污染	wū rǎn - pollution
汤	soup (tāng)
沙发	sofa (shāfā)
沙漠	shāmò - desert
没	(méi) not
没关系	(méi guān xi ) it doesn't matter; it's ok
没问题	(méi wèntí) no problems
河	hé - river
河流	hé liú -river
油	yóu - oil; oily
沿海	along the coast (yánhǎi)
法律	(fǎ lǜ) law, legal
注意	pay attention to (zhùyì)
洗	xǐ - to wash
洗澡	(xǐ zǎo) to take a bath, shower
洗衣机	washing machine (xǐyījī)
洗衣粉	xǐyīfěn - laundry powder
活力	huólì - vitality; energy
活动	activity (huódòng)
流	to flow (liú)
浪漫	(làngmàn) romantic
浪费	làng fèi - to waste, squander
海	Hǎi - sea; ocean
消息	xiāo xi - news, information
消费	xiāofèi - consume (goods or services), consumption
涨	zhǎng - to rise (of prices, rivers)
深	(shēn) deep
深	shēn - profound; intimate (of relations or feelings); deep, dark (color)
清楚	(qīng chu) clear, to understand
清淡	qīngdàn - light in flavor
清蒸	qīngzhēng - to steam (food without heavy sauce)
温度	Wēndù - temperature
渴	thirsty (kě)
游客	yóukè - tourist
游戏	game (yóu xì)
游泳	(yóu yǒng) to swim
游泳	(yóuyǒng) to swim
游泳	(yóuyǒng) to swim
游泳池	(yóu yǒng chí) swimming pool
游泳池	(yóuyǒng chí) swimming pool
游览	to go sightseeing; to tour; excursion (yóulǎn)
满	mǎn - full, complete
漂亮	(piàoliang) pretty
演	(yǎn) to show (a film); to perform
演唱会	vocal concert (yǎnchànghuì)
火车	huǒ chē - train
灯	(dēng) light
灯笼	dēng lóng - lantern
灰色	(húi sè) grey
炒	chǎo - to stir-fry; to sauté; to speculate (for profit)
点	(diǎn) o'clock
点（儿）	(diǎn[r]) a little, a bit
点菜	(diǎn cài) to order food
烘干机	hōnggānjī- clothes dryer
热	hot (rè)
热闹	rè nao - lively, bustling
然后	(rán hòu) then
煤	méi - coal
照片	(zhào piàn) photo; picture
照顾	(zhàogù) to look after, give consideration to
熊猫	xióngmāo - panda
熟悉	(shú xī) be familiar with, know well
熟悉	shú xī - be familiar with, know well
熬夜	áo yè - to stay up late or all night; to burn the midnight oil
爬山	pá shān - to climb/hike a mountain
爱	love (ài)
爱好	ài hào - hobby
爱情	(ài qíng) romantic love
父母	(fùmǔ) father and mother; parents
爸爸	(bàba) dad, father
片	(piàn) measure word for tablet; slice
牌子	páizi - brand
牙膏	toothpaste (yá gāo)
牛	(niú) cow; ox
牛仔裤	niúzǎikù - jeans
牛肉	beef (niúròu)
物理	(wù lǐ) physics
物美价廉	attractive goods at inexpensive prices （wù měi jià lián）
特别	(tè bié) especially
特色	tèsè - distinguishing feature or quality; characteristic
狐狸	fox (húli)
狗	(gǒu) dog
狗	dog (gǒu)
猫	(māo) cat
王	(Wáng) Wang
玩（儿）	(wán[r]) to have fun; to play
环境	huán jìng - environment, surroundings, situation
现在	(xiànzài) now
现象	xiàn xiàng - appearance, phenomenon
现金	cash (xiànjīn)
班	class (bān)
球	(qiú) ball
理解	to understand (lǐjiě)
理财	to manage money (lǐ cái)
瑜伽	yoga (yújiā)
瓶	(píng) (measure word for bottles); bottle
瓶装水	píngzhuāngshuǐ － bottled water
甚至	shèn zhì - even
甜	sweet (tián)
生	shēng - to give birth to; to be born
生日	(shēngrì) birthday
生气	shēng qì - angry
生活	(shēng huó) life, to live
生活	(shēng huó) life; to live
生活	（shēng huó）life, to live
生病	(shēng bìng) to get sick [vo.]
生词	(Shēngcí) new words; vocabulary
產業	industry (sector) (Chǎnyè)
用	(yòng) to use
用功	hard-working; diligent; studious (yònggōng)
由	(yóu) by, via, through; from
申请	shēn qǐng - application, to apply (school or a job)
电	(diàn) electricity
电	electricity (diàn)
电子邮件	(diàn zǐ yóu jiàn) email
电影	(diànyǐng) movie
电影院	diànyǐngyuàn - movie theater
电脑	(diànnǎo) computer
电视	(diànshì) television
电话	(diànhuà) telephone
男	(nán) male
男子	Nánzǐ - man; male
画画儿	to draw; to paint （huà huàr）
留（下）	to leave behind; to stay behind (liú (xià))
留学	liú xué - to study abroad
留学生	student studying abroad (liúxuéshēng)
番	Fān - (measure word for type or kind)
疼死	really painful (téng sǐ)
病人	patient (bìngrén)
痒	itchy (yǎng)
登机口	(dēngjīkǒu) boarding gate
登机牌	(dēngjīpái) boarding pass
百	(bǎi) hundred
的	(de) a possessive particle
的确	díquè - indeed; really; truly
盐	salt (yán)
盒饭	box lunch (héfàn)
盖	gài - to build; to construct
盘	(pán) plate; dish
直飞	(zhí fēi) fly directly
相信	xiāng xìn - to believe, trust
相处	to get along (xiāngchǔ)
省	shěng - province
省下来	shěng xia lai - to save (money, time)
省会	shěnghuì - provincial capital
省吃俭用	to be frugal with food and other living expenses (shěng chī jiǎn yòng)
省钱	(shěng qián) to save money, to be economical
省钱	（shěng qián）to save money; to economize
看	(kàn) to read, to see, to watch, to look at
看法	point of view (kànfǎ)
看病	(kànbìng) to see a doctor [vo.]
真	(zhēn) really
真心	zhēnxīn - sincere; wholehearted
真的	zhēn de - really; truly
眼睛	eye (yǎnjing)
着急	zháo jí - anxious, to worry
睡眠	Shuìmián - sleep
睡觉	(shuì jiào) to sleep
矛盾	máodùn - contradiction; contradictory
知识	zhī shi - knowledge
知道	(zhī dào) to know
知音	zhīyīn - someone who truly understands; soulmate
短	(duǎn) short
短	duǎn - short
石头	shí tou - stone, rock, pebble
石油	Shíyóu - petroleum; oil
砍	kǎn - to chop
研究	yán jiū - research, study
研究生	（yán jiū shēng）graduate student
研究生	(yánjiūshēng) graduate student
硕士	shuò shì - master's degree
硬	yìng - hard
碗	bowl (wǎn)
碰见	pèng jiàn - to bump into; to run into
礼物	(lǐwù) gift; present
社交媒體	social media (Shèjiāo méitǐ)
社会	society (shèhuì)
社會	society (Shèhuì)
祝	(zhù) to wish (well)
票	(piào) ticket
福	fú - blessing; good fortune
离	(lí) away from
离	(lí) away from
离	(lí) away from
秋天	autumn (qiū tiān)
种	(zhǒng) measure word for kinds, sorts, types
科	(kē) a branch of academic or vocational study
科学	kē xué - science; scientific; rational
租	to rent (zū)
移民	immigrant; to immigrate （yímín）
税	shuì - tax
空	Kōng - empty
空（儿）	(kòng[r]) free time
空气	(kōng qì) air
空气	kōng qì - air; atmosphere
空调	kōng tiáo - air conditioning
穿	(chuān) to wear
突然	tū rán - suddenly, unexpectedly
窗户	window (chuānghu)
站	(zhàn) station
站	(zhàn) station; stop
站	zhàn - station, stop, to stand
竟（然）	jìng(rán) - unexpectedly; contrary to one's expectation
童年	childhood (tóngnián)
笑	(xiào) to laugh, smile
笔	(bǐ) pen
笔	bǐ - m.w. for sums of money
第	(dì) Prefix for ordinal number
等	(děng) to wait; to wait for
等	děng - and so forth; etc.
等于	děngyú - to be equal to
筒	Tǒng - thick tube-shaped object; cylinder
答应	dāying - to agree (to do something); to promise; to answer
筷子	kuàizi - chopsticks
签	qiān - to sign; to autograph
签证	visa (qiānzhèng)
简单	(jiǎndān) simple
算	suàn - to count as; to be considered as
算了	(suàn le) forget it; never mind
管	guǎn - to control, manage; to mind, to care about
管理学院	school of management (guǎnlǐ xuéyuàn)
箱子	(xiāngzi) suitcase; box
篮球	basketball (lánqiú)
米饭	(mǐ fàn) cooked rice
粉红色	(fěn hóng sè) pink
粽子	zòngzi - pyramid-shaped dumplings of glutinous rice wrapped in bamboo or reed leaves
糖	(táng) sugar
糖醋鱼	(tángcùyú) sweet and sour fish
糟糕	(zāogāo) in a terrible mess; how terrible
系	xì - department (of a college or university)
素	(sù) vegetarian (food)
素餐	(sùcān) vegetarian meal
紧张	(jǐn zhāng) nervous, anxious
紫色	(zǐ sè) purple
累	(lèi) tired
經濟	economy (Jīngjì)
網上找資料	To search online (Wǎng shàng zhǎo zīliào)
红	(hóng) red
红包	hóngbāo - red envelope containing money to be given as a gift
红绿灯	traffic light (hónglǜdēng)
约	to make an appointment (yuē)
纪念品	Jìniànpǐn: Souvenir; keepsake; memento
纯棉	chúnmián - pure cotton; 100 percent cotton
纸	(zhǐ) paper
纽约	(Niǔyuē) New York
线	(xiàn) line
线	(xiàn) line (metro)
练习	(liànxí) to practice
终于	zhōng yú - finally
经常	jīng cháng - often, regularly
经济	(jīng jì) economy, economics
经济	jīng jì - economy, economics
经验	jīng yàn - experience; to experience
结婚	jié hūn - to get married
结束	jié shù - end, to finish
结果	jié guǒ - as a result
给	(gěi) to give
给	(gěi) to; for
继续	jì xù - to continue, go on
维度	latitude (wěidù)
绿色	(lǜ sè) green
缺点	(quē diǎn) - weakness, fault, pit fall
网上	on the Internet (wǎng shang)
网球	tennis (wǎngqiú)
网站	website (wǎngzhàn)
网络	wǎngluò - network, internet
美	měi - beautiful, good
美丽	měi lì - beautiful
美元	(měiyuán) American dollar
美国	(Měi guó) America
美式	(měishì) American style
美满	měimǎn - happy and satisfying
羡慕	(xiàn mù) to admire, envy
翻译	fān yì - translation, to translate
老外	lǎowài - foreigner
老太太	elderly lady (lǎo tài tai)
老师	(lǎo shī) teacher
老年	old age (lǎo nián)
老是	lǎoshì - always
老百姓	lǎobǎixìng - common folk; ordinary people
老闆	boss (Lǎobǎn)
考虑	kǎo lǜ - to consider, think over
考试	(kǎo shì) to give or take a test; test
而	(ér) conjunction to connect two clauses
聊天（儿）	(liáo tiān[r]) to chat
职业	zhí yè - occupation, profession
聪明	intelligent, clever, smart (cōng ming）
肉	meat (ròu)
肚子	(dùzi) belly; abdomen
股市	stock market (gǔ shì)
股票	gǔ piào - stock, share
肯定	kěn dìng - definitely
背景	background (bèi jǐng)
胖	fat (pàng)
能	(néng) can; be able to
能源	néngyuán - energy; energy source
脑	(nǎo) brain
脚	foot (jiǎo)
脚步	footstep (jiǎobù)
脸	face (liǎn)
脾气	(pí qi) temper
自己	(zìjǐ) oneself
自然	(zì rán) naturally, certainly
自然	zì rán - nature, natural, naturally
自由	(zìyóu) free, unconstrained
自由	（zìyóu）freedom, free
自行车	zì xíng chē - bicycle
至于	zhìyú - as for; as to
舅妈	jiùmā - wife of mother's brother
舅舅	jiùjiu - mother's brother
舒服	comfortable (shūfu)
航班	(hángbān) scheduled flight; flight number; plane; scheduled sailing; sailing number; passenger ship
航空	aviation (hángkōng)
船	chuán - boat, ship
良好	liánghǎo - good
节	(jié) measure word for class periods
节日	jié rì - festival, holiday
节约	jié yuē - to save, economize, to conserve
芥兰	Chinese broccoli (jièlán)
花	(huā) flower
花	(huā) to spend (money, time)
英文	(Yīngwén) English language
苹果	apple (píngguǒ)
茶	(chá) tea
茶馆	cháguǎn - teahouse
药	medicine (yào)
药店	pharmacy (yàodiàn)
菜	(cài) dishes, cuisine
菜单	menu (càidān)
菠菜	spinach (bōcài)
营养	nutrition; nourishment (yíng yǎng)
落伍	luòwǔ - to lag behind; to be outdated
蓝色	(lán sè) blue
薪水	xīnshuǐ - salary; pay; wages
藝術博物館	art museum (Yìshù bówùguǎn)
虛假信息	disinformation (Xūjiǎ xìnxī)
虽然	(suī rán) although
蛋糕	cake (dàngāo)
融入	róngrù - to merge into; to meld into
行	(xíng) all right; O.K.
行李	luggage (xíngli)
街	jiē - street
衣服	(yī fu) clothes
衣柜	（yī guì）wardrobe
衣食住行	yī shí zhù xíng - food, clothing, shelter, and transportation (basic necessities of life)
补充	bǔchōng - to supplement; to replenish
表哥	biǎogē - older male cousin of a different surname
表姐	older female cousin (biǎojiě)
表演	biǎo yǎn - performance, to perform
表现	biǎo xiàn - to show, display, to manifest
衬衫	(chèn shān) shirt
袜子	(wà zi) socks
被	(bèi) by (structural word)
被子	(bèi zi) comforter; quilt
裤子	(kùzi) pants
西	west (xī)
西瓜	watermelon (xīguā)
西装	(xī zhuāng) business suit
要	(yào) to need; to take
要	(yào) to want
要	(yào) will, be going to; to want to
要不是	yàobúshì - if it were not for; but for
要不然	(yàoburán) otherwise; or else; or
要么。。。要么。。。	if it's not..., it's...; either... or ... (yào me...yào me)
要是	(yàoshi) if
见	(jiàn) to see
见面	(jiàn miàn) to meet up; to meet with
规定	guī dìng - provision; regulations; rules
视	(shì) vision
觉得	(juéde) to feel; to think
解决	jiě jué - to solve, settle a dispute
誇張(eh)	exaggerate (Kuāzhāng)
警察	(jǐng chá) policeman
警察	(jǐng chá) policeman
计划	(jìhuà) plan; to plan
计时	Jìshí - to count time
订	(dìng) to reserve; to book (a ticket, a hotel room, etc.)
认为	to think; to consider (rènwéi)
认识	(rènshi) to be acquainted with; to recognize
讨厌	tǎo yàn - nasty, to dislike, to loathe, disgusting, disagreeable
讨论	to discuss (tǎolùn)
让	(ràng) to let, allow, make
记仇	jìchóu - to bear a grudge; to harbor resentment
记得	to remember (jìde)
讲	jiǎng - to speak; to tell
设计	shè jì - design
试	(shì) to try
语法	(yǔ fǎ) Grammar
语言学	(yǔyánxué) linguistics
说	(shuō) to speak, to say
说不定	shuōbudìng - perhaps; maybe
说服	shuō fú - persuade; convince
说话	(shuō huà) to talk
请	(qǐng) please
请客	(qǐng kè) to invite someone (to dinner, coffee, etc.); to play the host
读书	dú shū - to attend school; to study; to read aloud
课	(kè) class; course; lesson
课文	(Kèwén) text of a lesson
课表	(kèbiǎo) class schedule
谁	(shéi) who; whom
谈	tán - to talk; to chat; to discuss
谢谢	(xièxie) thank you
谷歌	Google (Gǔgē)
豆腐	(dòufu) tofu; bean curd
负担	fù dān - burden
质量	zhì liàng - quality
贫	pín - gabby; glib
购物	gòu wù - shopping
贴	tiē - to paste; to glue
贵	(guì) honorable
贷款	dàikuǎn - loan; to provide a loan
费	(fèi) fee; expenses; charge
费	(fèi) to spend; to take (effort)
资料	zīliào - material
赔	to lose (money, etc.); to suffer a loss in deal (péi)
赚钱	zhuàn qián - to earn money
赞成	zànchéng - approve of; favour; agree with; endorse
赢	yíng - to win
走	(zǒu) to go by way of; to walk
走路	to walk (zǒu lù)
走道	aisle (zǒudào)
赶快	(gǎnkuài) right away; quickly; in a hurry
起床	(qǐchuáng) to get up, to get out of bed
起飞	(qǐ fēi) to take off (in an airplane)
超市	(chāo shì) supermarket
超市	(chāoshì) supermarket
超市	chāo shì - supermarket
超过	chāo guò - to surpass, exceed
超重	(chāozhòng) to be overweight (of luggage, freight, etc.)
越来越	(yuè lái yuè) more and more
足球	(zúqiú) soccer; football [n.]
跌	(diē) to fall
跑步	(pǎobù) to jog
跑步	(pǎobù) to jog, run
跟	(gēn) with
路	(lù) bus number...
路	(lù) road; path
路口	intersection (lùkǒu)
路线	lùxiàn - route; itinerary
跳舞	(tiào wǔ) to dance
踢	(tī) to kick, to play (soccer)
身体	body; health (shēntǐ)
身材	shēncái - stature; figure; build
躺下	(tǎngxià) to lie down
车	(chē) vehicle; car
车厢	chēxiāng - railway carriage
转机	change planes (zhuǎn jī)
软	ruǎn - soft
软件	software (ruǎnjiàn)
轻松	qīng sōng - gentle, relaxed
辆	(liàng) measure word for vehicles
辆	（liàng）measure word for vehicles
输	shū - lose (a game)
辛苦	xīn kǔ - laborious, hard work, to go to trouble
辣	(là) hot, spicy
辣	là - spicy
过	(guò) indicates past tense
过	(guò) indicates past tense; to pass (a holiday, festival)
过几天	in a few days (guò jǐ tiān)
过敏	(guòmǐn) to be allergic to
过节	(guò jié) to celebrate a holiday
运动	(yùndòng) sports
运动	(yùndòng) sports, exercise
运动服	(yùndòngfú) sportswear, athletic clothing [n.]
近	(jìn) close, near
近	(jìn) close; near
近	(jìn) near
还	(hái) also; too; as well
还	(huán) to pay back; to return
还是	(háishì) or
这	(zhè) this
这么	(Zhème) so; this (late, etc.)
这儿	(zhèr) here
进	(jìn) to enter
进来	(jìn lai) to come in
进步	Jìnbù - to make progress
远	(yuǎn) far
远	(yuǎn) far
远	far (yuǎn)
连	even (lián)
迟到	chí dào - to arrive late
迷	mí - fan; to be infatuated with
退休	tuì xiū - retire
送	(sòng) to give as a gift
送	(sòng) to see off or out; to take
适合	(shì hé) to fit; to suit
适合	shì hé - to fit; to suit
适应	(shì yìng) to adapt, to become accustomed to
适应	（shì yìng）to adapt
选	to choose (xuǎn)
选择	xuǎn zé - choice, to choose
逐渐	zhú jiàn - gradually, little by little
逗	dòu - to tease; to play with; amusing
通常	(tōng cháng) usually
造成	zào chéng - to cause; to give rise to
遍	( biàn) measure word for complete courses of an action or instances of an action
道歉	dào qiàn - to apologize
道理	reason; sense (dàoli)
那	(nà) in that case
那	(nà) that
那么	(indicating degree) so, such (nàme)
那儿	(nàr) there
郁闷	yùmèn - gloomy; depressed
部	bù - part; section
都	(dōu) both; all
酒	jiǔ - alcohol; liquor
酷	(kù) cool
酸	sour (suān)
酸辣汤	(suānlàtāng) hot and sour soup
醋	vinegar (cù)
里边	( lǐ biān ) inside
里面	(lǐ miàn) inside
里面	(lǐ miàn) inside
重	(zhòng) heavy; serious
重男轻女	zhònɡ nán qīnɡ nǚ - regard man as superior to woman
重要	important (zhòngyào)
重视	zhòng shì - to attach importance to; to think much of
金融	jīnróng - finance; banking
钟头	hour (zhōngtóu)
钢琴	gāng qín - piano
钱	(qián) money
铅笔	(qiān bǐ) pencil
银行	(yín háng) bank
银行	(yínháng) bank
银行	bank (yínháng)
错	(cuò) wrong
错	(cuò) wrong
锻炼	duàn liàn - to exercise
长	(cháng) long
长	long (cháng)
长	long (cháng)
长	to grow, to appear (zhǎng)
长城	(chángchéng) the Great Wall
长大	to grow up (zhǎng dà)
长江	cháng jiāng - Yangtze river
长短	(cháng duǎn) length
门	door (mén)
门	m.w. for academic courses (mén)
门口	mén kǒu - doorway / gate, entrance
门票	ménpiào - admission ticket; admission fee
问	(wèn) to ask
问题	(wèntí) question
闹	nào － to suffer from；to make a noise；noisy
闹别扭	nào bièniu - to have a small conflict; to be at odds (with someone)
队	duì - m.w. for teams and lines
队员	team member (duìyuán)
附近	(fù jìn) nearby, in the vicinity
附近	(fù jìn) nearby, in the vicinity
附近	(fùjìn) nearby
陌生	mò shēng - strange, unfamiliar, unkown
除了...以外	(chú le ... yǐ wài) in addition to; besides
除夕	Chinese New Year's Eve (chúxī)
陪	péi - to accompany
随便	suí biàn - "whatever", casual, careless, to do as one pleases
随手	without extra effort or motion; conveniently (suí shǒu)
难	(nán) difficult
难受	(nán shòu) uncomfortable, hard to bear
难吃	nánchī - not tasty
难怪	nán guài - no wonder
难过	nán guò - feel sorry; sad; hard to bear
难道	Do you mean to say... (nándào)
集中	to concentrate; to be concentrated (jízhōng)
雞尾酒	cocktail (Jīwěijiǔ)
零用钱	língyòngqián - allowance; spending money
需要	xū yào - need
非...不可	have to; nothing but...would do (fēi...bùkě)
非常	(fēicháng) extremely, very
靠	(kào) to lean on; to lean against; to be next to
面	miàn - noodles
面积	miàn jī - area
面试	(miànshì) to interview; interview
鞋	(xié) shoes
鞭炮	biān pào - firecrackers
音乐	(yīnyuè) music
音乐会	(yīn yuè huì) concert
顺利	shùn lì - smoothly, successfully
顿	dùn - measure word for meals
预报	forecast (yùbào)
颜色	(yán sè) color
风	fēng - wind
风俗	fēng sú - custom
风景	fēng jǐng - scenery, landscape
风险	fēng xiǎn - risk, hazard
飞	(fēi) to fly
飞机	(fēi jī) airplane
飞机场	(fēi jī chǎng) airport
餐	cān - meal
餐具	cānjù - eating utensils; tableware
餐厅	(cān tīng) cafeteria
餐巾	napkin (cānjīn)
餐馆儿	cānguănr - restaurant
饭	(fàn) meal, (cooked) rice
饭桌	dining table (fànzhuō)
饭馆儿	restaurant (fànguǎn(r))
饮料	(yǐn liào) beverage, drinks
饮食	yǐnshí - food and drink，diet
饱	bǎo - to eat till full; satisfied
饺子	dumplings (jiǎozi)
饿	hungry (è)
首都	(shǒu dū) capital city
香	xiāng - fragrant
香港	Hong Kong (Xiānggǎng)
马上	(mǎ shàng) immediately, at once
马虎	mǎhu - careless; perfunctory; mediocre
马路	mǎ lù - street / road
骄傲	jiāo ào - proud, arrogant, full of oneself, pride
骑	qí - to ride
骑自行车	(qí zìxíngchē) to ride a bicycle
高中	gāozhōng - senior high school
高兴	(gāoxìng) happy, pleased
高原	gāoyuán - plateau
高速公路	(gāosù gōnglù) highway
鱼	fish (yú)
鸡	chicken (jī)
麻将	mahjong (má jiàng)
麻烦	(má fan) troublesome
黄	(huáng) yellow
黄河	Huáng Hé - Yellow River
黄瓜	cucumber (huáng guā)
黑	(hēi) black
默写	(Mòxiě) quiz
鼻子	nose (bí zi)
