aan boord	on board
aanbieding, de	special offer
aandacht, de	attention
aangeboren	innate
aankleden	to dress
aankomen	arrive
aankomst, de	arrival
aankoop, de	purchase
aanleggen	to construct
aanleunwoning, de	sheltered accommodation
aannemelijk	plausible, acceptable
aanpakken	organise
aanrecht, het	counter (kitchen)
aansprakelijkheid, de	liability
aantal	the number of
aantekenen	register
aantonen	to demonstrate, to prove
aantreffen	to find
aantrekkelijk	attractive
aanvragen	apply for
aanwezig	present
aanzetten	turn on
aardig	nice
aardig vinden	like
absoluut	absolute
accepteren	accept
achter elkaar	one after another
achteraf	afterwards
achtergrond, de	background
actie, de	action, activity
actief	active
activiteit, de	activity
advertentie, de	advertisement
af en toe	occasionally
afgesproken	agreed
afhangen	depend
afhankelijk	dependent
afkoelen	cool down
afnemen	decrease
afpakken	to take away, snatch
afrekenen	pay
afscheid, het	departure, farewell
afschuwelijk	horrible, awfully
afstand, de	distance
afstuderen	graduate
afvallen	to lose weight
afvragen, zich	to wonder, to doubt
afwasmachine, de	dishwasher
afwassen	to wash the dishes
afwisseling, de	variation
afzeggen	cancel
afzuigkap, de	cooker hood
agressie, de	aggression
agressief	aggressive
alleenstaand	single
allemaal	all
als	if, when
alternatief, het	alternative
altijd	always
amper	barely, hardly
andersom	vice versa
anderzijds	on the other hand
apart	to be separated
apotheek, de	pharmacy
apparaat, het	machine, appliance
arbeid, de	work, labour
arbeider, de	worker
argument, het	argument
armband, de	bracelet
armoede, de	poverty
artikel, het	article, item
asociaal	anti-social
assistente, de	assistant
au	ouch
autochtoon, de	native
automobilist, de	driver
baan, de	job
bagage, de	luggage
bak, de	box
bakken	fry
balie, de	counter
band, de (auto, fiets)	tire
band, de (familie)	(family) tie
basisschool	primary school
bedenken	to devise, think up
bedrag, het	sum of money
bedreigen	to threaten
bedrijf, het	company
beëindiging, de	termination
beek, de	brook, stream
beeld, het	screen
been, het	leg
begeleiden	to accompany, to coach
begeleiding, de	accompaniment
begrafenis, de	funeral
begrijpen	understand
beheren	to manage
behoorlijk (tamelijk)	substantially
beide	both, either
bejaarde, de	elderly man
bekend	well-known
bekendmaken	give notice of
beker, de	cup
bel, de	bell
belachelijk	ridiculous, absurd
belangstelling, de	interest
beleefd	polite, courteous
beleggen	to cover, to put on
beleid, het	policy
belevenis, de	experience, adventure
beloven	to promise
bemanningslid, het	crew member
benzinestation, het	petrol station
beoordelen	judge
bepaald	particular, specific
bepalen	determine
bereiden	to prepare
bereikbaar	accessible
bereikbaar	reachable
bereiken	to reach, accomplish
berg, de	mountain
bericht	report
beroemd	famous
beroep, het	profession
beschadigd	damaged
bescheiden	modest
beschermen	to protect
beschikbaar	available
beschrijven	describe
beschrijven	to write on, to describe
beschuit, de	Dutch biscuit
beslissing, de	decision
besluiten	decide
bestaan uit	consist of
besteden	to spend
bestelling, de	order
bestemming, de	intention, purpose
betaling, de	pay
beterschap	get well soon
beurt, de	overhaul, servicing
bevatten	contain
bevestigen	to confirm
bevolking, de	population
bewaren	keep, store
bewegen	move
bewerken	edit
bewolkt	clouded
bewust	aware
bezig zijn met	working on
bezigheid, de	activity, occupation
bezit, het	property
bezorgd	concerned for
bezuinigen, de bezuiniging, de	to save, saving
bibliotheek, de	library
bieden	offer
bijna nooit	hardly
bijvoorbeld	for example
bijwerking, de	side effect
bil, de	buttock
binden	to unite
binnen	inside
binnenkort	son, shortly
binnenstad, de	city centre
biologie, de	biology
blad, het	magazine
blaffen	bark
blij	glad, happy
blijken	appear
blijven	stay
blijven (werken)	go/ keep on
blik, de	a look
bloeddruk, de	blood pressure
bloemkool, de	cauliflower
blut	broke
bod, het	offer
boer, de	farmer
bom, de	bomb
boodschap, de	message
boos	angry
bord, het	notice, sign
bord, het	plate
borst, de	chest
borstel, de	brush
borstvoeding, de	breast-feeding
bos, de	bouquet
bos, het	woods, forest
bouwen	to build
bovendien	furthermore
brand, de	fire
breed	wide
breedte, de	width, breadth
breken	to break
brengen	to bring
brommer, de	moped, motorbike
broodje, het	roll
brutaal	impertinent, shameless, bold
bruto	gross
budget, het	budget
bui, de	shower
buitenlander, de	foreigner
buren, de	neighbours
buurt, de	neighbourhood
cabaretier (cabaretière), de	cabaret performer
cadeau, het	gift
cadeaubon, de	gift certificate
calorie, de	calorie
camera, de	camera
cent, de	cent, penny
chagrijn, het	chagrin, annoyance
chauffeur, de	driver
chips, de	crisps
chocola, de	chocolate
college, het	lecture
combineren	combine
communiceren	to communicate
conducteur, de	conductor, ticket-collector
constant	constant
contact opnemen met	contact
contant	in cash
controleren	check
criminaliteit, de	criminality
cultureel	cultural
daardoor	because of that
daarnaast	beside it, in addition to
dadelijk	in a moment / minute
dalen	decrease
dam, de	dam
dansen	dance
darm, de	intestine, bowel
de afdeling	department
de bewoner	inhabitant
de boter	butter
de brievenbus	postbox
de buik	belly
de dingen	things
de eeuw	century
de eis	requirement
de gang	hall, passage
de gebeurtenis	event
de gegevens	details
de gezondheid	health
de gracht	canal
de kaart	postcard
de postbode	postman
de postzegel	stamp
de prestatie	achievement
de sfeer	atmosphere
de sollicitant	applicant
de spullen	stuffs
de verwijsbrief	referral
De volgende taken zitten niet in het programma. De woorden hoef je niet te leren voor de toets	
de volwassene	adult
deel, het	section
deur, de	door
dicht	blocked, closed
dieet, het	diet
dief, de	thief
diefstal, de	theft
dijk, de	dike
dik	swollen
direct	direct
discipline, de	discipline
discussie, de	discussion
discussiëren	to discuss
doek, de	cloth, canvas, curtain
doel, het	target, goal
dokter	doctor
dominant	dominant
dood	dead
doodmoe	dead tired
dooien	thaw
doordat	because of
doorgaan (een vergadering gaat door)	go ahead as planned
doorgaan met	continue
doorgeven	pass on to
doorkomen	to come through
dosering	dose
downloaden	to download
draaien	to turn, to rotate
dragen	wear
drank, de	drink
dreunen	drone, thud
dringend	urgent
dromen	to dream
droog	dry
druk	busy
druppel, de	drop
duidelijk	clear
duinen, de	dunes
dun	thin
durven	dare
duur, de	duration
dwingen	to force
echter	however, nevertheless
echtgenoot, de	spouse
eenzaam	lonely
eerder	previously
eerlijk	honest
effect, het	effect
eigen	own
eigenlijk	actually, in fact
eigenschap, de	quality
eigenzinnig	self-willed
ellende, de	misery
emotie, de	emotion
emotioneel	emotional
en toen	and then
energie, de	energy
enerzijds	on the one hand
eng	scary
enige, het	only, some, wonderful
enkel(e)	some, a few
enkele	one way
enorm	enormous
enthousiast	enthusiastic
envelop, de	envelope
ergens (kan ik u verder nog ergens mee helpen?)	somewhere (Can I be of any further assistance?)
ernstig	serious
ervaren	experience
ervaring, de	experience
etiket, het	label, tag
even	for a moment
eventueel	possibly
examen, het	exam
expressief	expressive
familielid, het	relative
fase, de	phase
fietsenmaker, de	bicycle repairman
figuratief	figurative
fijn	fine, great
file, de	traffic jam
flauwvallen	to faint
flexibel	flexible
flink	substantial
fornuis, het	stove, oven
fotograaf, de	photographer
frisdrank, de	soft drink
fruiten	to fry
fysiotherapie, de	physiotherapy
gaaf	great, fantastic
gaar	cooked thoroughly
garage, de	garage
garantie, de	guarantee
gast, de	guest
gauw	soon
geachte	respected, esteemed
gebeuren	happen, be done
gebied, het	territory, district
gebrek, het	lack, shortage
gebruiken	use
gebruiksaanwijzing, de	directions (for usage)
gedachte, de	thought
gedicht, het	poem
gedoe, het	fuss
gedogen	to tolerate
gedrag, het	behaviour
geestelijk	mental
geestig	witty, funny
gegevens, de	personal information
gehorig	noisy
gehuwd	married
gek	crazy
gel, de	gel
gelden	to hold well, to apply, to be valid
geldig	valid, current
geleden	ago
gelegenheid, de	opportunity
gelijk blijven	stay the same
geluid, het	sound
gemak, het	comfort
gemakkelijk	easy
gemiddeld	average
geneeskunde, de	medicine
geneesmiddel, het	medicine
generatie, de	generation
genieten	enjoy
genoeg	enough
genotmiddel, het	stimulant
genuanceerd	subtle
gepensioneerd	retired
geruststellen	to reassure
geschikt	suitable
geul, de	trench, channel
gevaar, het	danger
gevaarlijk	dangerous
gevoel, het	feeling
gevoelig	sensitive
gevolg, het	result, consequence
geweld, het	violence
gewond (raken)	to be injured
gewoonte, de	custom, practice
gezeur, het	nagging, moaning
gezond	healthy
gezondheid, de	health
gillen	scream
gooien	to throw
gootsteen, de	kitchen sink
goud	gold
graad, de	degree
grafiek, de	graphics
grap, de	joke
grappig	funny
groeien	grow
grootmoeder, de	grandmother
grootouders, de	grandparents
hakken	to chop (up)
handelen	to do business
handig	handy
hangen	hang
heden	present (day)
heftig	intense, fierce
heide, de	heath(land), heather
hekel (een hekel hebben aan)	hate, dislike
helder	bright
heleboel (een heleboel)	a lot
helemaal	completely, entirely
herhaling	repetition
herinneren, zich	to remember
hersenen, de	brain
herstellen	to recover, to repair
het bewijs	proof
het bezoek	visit, visitors
het bureau	agency
het gesprek	conversation
het gewicht	weight
het hangt er vanaf	it depends
het hoofdkantoor	head office
het huwelijk	marriage
het is raak	here we go again
het kruispunt	crossroads
het milieu	environment
het overzicht	survey
het pakket	package
het papier	paper
het spoedgevaal	emergency
het vak	subject
het vet	fat
hetzelfde	the same
hetzij ... hetzij	either ... or
hip	trendy
hobby, de	hobby
hoek, de	corner, angle
hoesten	cough
hoeveelheid, de	amount, quantity
hoeven	have to, need
hoewel	even though
hogeschool, de	college
hond, de	dog
hoofd, het	head
hoofdpijn, de	headache
hoogachtend	sincerely (esteemed)
hoogtepunt, het	highlight
hopen	hope
horen	hear
hout, het	wood
huidskleur	skin color
huilen	to cry
huiselijk	homey
huishouden, het	household
huismerk, het	own brand
hulp, de	help
hulpverlening, de	aid, relief, assistance
humor, de	humour
ideaal	ideal
ideaalbeeld	ideal picture
identiteit	identity
ieder	every/any
iedereen	everyone
iemand	somebody
iets niet erg vinden	don't mind
ik kan er niks aan doen	I can't do anything about it.
immigrant, de	immigrant
impulsief	impulsive
in dat geval	in that case
in de toekomst	in the future
inademen	breathe in
inboedel, de	furniture, furnishings
inbraak, de	burglary
inbreken	to break into (a house)
inderdaad	indeed
individu, het	individual
indruk, de	impression
infectie, de	infection
ingewikkeld	complicated
ingrediënt, het	ingredient
inhouden	imply
inhouden (betekenen)	mean
inmiddels	by now
inpakken	wrap (as a gift)
insteken	insert
instellen	to establish, to adjust
interessant	interesting
interesse, de	interests
internationaal	international
intoetsen	enter
invloed, de	influence
inzien	to glance over, to have a look at
inzittende, de	passenger
jenever, de	Dutch gin
jeugd, de	youth
jongere, de	young person
juffrouw, de (school)	miss (school)
juist	right, correct
kabel, de	cable
kanaal, het	channel
kanker	cancer
kans, de (kans op)	chance (of)
kant	side
kant-en-klaarmaaltijd, de	ready meal
kantine, de	canteen
kapsel, het	haircut
karakter, het	character
karakteriseren	to characterize
kat, de	cat
katholiek	catholic
kauwgom, de	chewing gum
keel, de	throat
kenmerk, het	characteristic, identifying mark
kennis, de	acquaintance
kerncentrale, de	nuclear power plant
Kerstmis	Christmas
ketting, de	chain
keuren	to test, to sample, to inspect
keuze, de	choice
kiosk, de	kiosk
kist, de	coffin
klaarmaken	get ready, prepare, cook
klacht, de	complaint
klagen	to complain
klap, de	bang, crash
klasgenoot, de	classmate
klassiek	classic
kleding, de	clothes
kleed, het	carpet
kleingeld, het	small change
kleinkind, het	grandchild
klikken (het klikt)	get along well
klimmen	to climb
klinken	sound
klomp, de	clog
klus, de	job, task
knie, de	knee
knooppunt, het (verkeer)	highway intersection
knop, de	button
knuffelen	to cuddle
koe, de	cow
koel	cool, cold
koelkast, de	refrigerator
koffer, de	suitcase
kok, de	chef
konijn, het	rabbit
kooi, de	cage
koopje, het	bargain
koopjesjager, de	bargain hunter
koorts, de	fever
koppel, het	couple
kou, de	coldness, chill
kraan, de	tap, faucet
kracht, de	strength, power
krachtig	powerful
krantenkop, de	headline
krat, de	crate
kritisch	critical
kruipen	to crawl
kunst, de	art
kunstenaar, de	artist
kuur, de (antibioticumkuur)	cure
kwaad (zijn)	angry
kwaliteit	quality
kwetsbaar	vulnerable
kwijt	lost
lachen	laugh
lamp, de	lamp
landbouw, de	agriculture
landen	to land
landschap, het	landscape
langzamerhand	gradually
last hebben van	suffer from
laten	to let
lawaai, het	noise
leeg	empty
leer, het	leather
leerling, de	student
legalisering, de	legalization
leggen	to lay
legitimatiebewijs	identification
legitimatiebewijs, het	identification
leider, de	leader
lek	flat
lelijk	ugly
lenen	borrow
lening, de	loan
lepel, de	spoon
leraar, de	teacher
leren	learn
letten op	pay attention to
letterlijk	literal, literally
leven	live
levensgevaar	life in danger
lichaam, het	body
lichamelijk	physical
licht, het	light
lid	member
lid, het	member
lidmaatschap	library membership
lief	kind, nice, sweet
liefde, de	love
liften	to hitchhike
liggen (waar liggen de formulieren?)	lie (Where are the forms?)
lijn, de	line
literatuur, de	literature
longen, de	lungs
looptijd, de	term
los	loose
loskloppen	to knock loose
lucht, de	sky
lui	lazy
lukken	manage
maaltijden	meals
maar	but, only
maatschappelijk werker, de	social worker
maatschappij, de	society
machteloos	powerless
magnetron, de	microwave
maken (repareren)	to repair
makkelijk	easy
materiaal, het	material
maximaal	maximal
mazzel, de	
mededeling, de	announcement
medewerker, de	staff member
media, de	media
medicijn, het	medicine
meegeven	give
meevallen (dat valt wel mee)	that's not so bad
meisje, het	girl
melden	to report
menen (dat meen je niet)	you are kidding
mengen	to mix
mening, de	opinion
mens, de	human
merk, het	brand
merken	to notice
meteen	right away, direct
middel, het	means
middelbaar (middelbare school)	secondary school
midden	middle
mie, de	noodles
minimaal	at least
missen	miss
moe	tired
moeilijk	difficult
mogelijk	possible
molen, de	windmill
momenteel	at present
mondeling	orally
monteur, de	mechanic
moskee, de	mosque
motivatie, de	motivation
motor, de	engine
muur, de	wall
muziekinstrument, het	music instrument
na een tijdje	after a while
naast	next to
nabestaande, de	(surviving) relative
nadeel, het	disadvantage
nadenken (over)	consider
nadoen	to imitate
nat	wet
natuur, de	nature
nauwelijks	hardly, scarcely
neef, de	nephew
neerstorten	crash
negatief	negative
nergens	nowhere
net (nette)	neat
netto	net
neus, de	nose
nicht, de	niece
niveau, het	level
nodig hebben	need
noemen	to mention, to call
nogal	rather
noorden, het	north
noot, de	nut
nuchter	sober
oefenen	train, practice
olijf, de	olive
oma, de	grandma
omdat	because
omgaan met	handle, manage
omgeving, de	neighbourhood
omheen	around, about
omhoog	upwards
omhooggaan	to go upwards, to increase
omroepen	to call, to page
ondanks	in spite of
onder de voet lopen	trample
onderdeel, het	part
onderhandelen	to negotiate
onderhoud, het	maintenance
onderscheid, het	distinction (between)
ondertussen	meanwhile
onderweg	on the way
onderwerp, het	subject
onderwijs, het	education
onderzoek, het	research
onderzoeken	examine
onderzoeker, de	researcher
ongedierte, het	vermin
ongelofelijk	incredible, unbelievable
ongeluk, het	accident
ongemakkelijk	uncomfortable
ongerust	worried
ongezond	unhealthy
onmiddellijk	immediate
onsteking	infection
ontkennen de ontkenning	to deny, denial
ontmoeten	meet
ontslag, het	dismissal, discharge
ontspannen	relax
ontstaan	arise, develop
ontvagen	receive
ontwerp, het	draft, design
ontwikkelen, zich	to develop
ontwikkeling, de	development
ontzettend	awfully, very
onvergelijkbaar	incomparable
onvoldoende	unsatisfactory
onweer, het	thunder
onzeker	uncertain, doubtful
ooit	one day
oom, de	uncle
oordeel, het	judgement, verdict
oorlog, de	war
oorspronkelijk	original
oorzaak, de	cause
oosten, het	east
oosters	oriental, eastern
op weg zijn naar	on your way
opa, de	grandpa
opbergen	to put away
opbouwen	to build up
opeens	suddenly
openbaar	public
openbaar vervoer	public transport
openen	open
opgewekt	cheerful
ophalen	collect
ophangen	to hang up
ophouden	to stop
opknappen	to tidy up
opleiding, de	training, schooling
opletten	pay attention
oplopen	to increase
opnemen (in een ziekenhuis)	hospitalize
opnieuw	once again/ all over again
oppassen	to baby-sit
opruimen	to clear out
opschrijven	write down
opschrijven (schrijf...op, schrijft...op)	to write down
opslaan	to store
opstaan	stand up
optellen	to add up
optimistisch	optimistic
optreden, het	performance
opvallen	to attract attention
opvallend	striking
opvoeden	to raise (your kids)
opvoeding, de	up bringing
opzoeken	look up
organisatie, de	organization
orkest, het	orchestra
ouder, de	parent
oudere, de	elder (older person)
oven, de	oven
overal	everywhere, anywhere
overdag	by day
overeenkomst, de	similarity
overgaan	pain is over
overgaan (pijn, ziekte)	wear off
overgang, de	transition, change over
overgevoelig	hyper-sensitive
overgewicht, het	overweight
overgrootmoeder, de	great-grandmother
overheid, de	government
overigens	anyway
overlast, de	inconvenience
overledene, de	deceased person
overleggen	consult
overleggen	to consult
overleven	survive
overlijden	to die, pass away
overstekken	cross
overstromen	to flood
overtuigen	to persuade
oververmoeid	exhausted
overweg kunnen met	handle
pak, het (koffie, melk)	pack
pakken (een koffer)	pack (a suitcase)
paksoi, de	Chinese cabbage
pan, de	(sauce)pan
paraplu, de	umbrella
pardon	pardon
parfum, het	perfume
parkeerplaats, de	parking space
pas, de	bank card
pasfoto, de	passport photo
paspoort, het	passport
passagier, de	passenger
passen (geld)	pay with the exact amount
patiënt, de	patient
pech, de	bad luck
pen, de	pen
pensioen, het	pension
percentage, het	percentage
perron, het	platform
personeel, het	staff
persoon, de	person
pesten	to pester, to nag
pijn, de	pain
pijnstiller, de	painkiller
pikken	to lift, to steal, to pinch
piloot, de	pilot
plaatje, het	image
plafond, het	ceiling
plank, de	board, shelf
plannen	to plan
plant, de	plant
platteland, het	country-side
plek, de	place, spot
plicht, de	duty
plotseling	sudden, unexpected
poep, de	poop
polder, de	polder (area drained for agriculture)
populair	popular
positie, de	position
positief	positive
praktijk, de	clinic
premie, de	premium, prize
prettig	pleasant, nice
procent, het	percentage
produceren	to produce, to manufacture
product, het	product
proefdier, het	test animal
proeven	taste
professioneel	professional
proficiat	congratulations
prognose, de	prognosis
programma, het (wasmachine)	cycle
protestants	protestant
puberteit, de	puberty
publiceren	publish
publiciteit, de	publicity
publiek, het	public
punt, het (score)	point
puzzelen	to solve puzzles
raar	strange
rage	rage, mania
ramp, de	catastrophe
rand, de	edge, border
rat, de	rat
reactie, de	reaction
realistisch	realistic
recept, het	recipe
recept, het (van de dokter)	prescription
receptioniste, de	receptionist
rechter, de	judge
reclamebureau, het	advertising agency
redelijk (in redelijke staat)	average (in average condition)
reden, de	reason
regeimatig	regularly
regel, de	rule
regelen	to regulate
regen, de	rain
regering, de	government
regio, de	region
regisseur, de	director
reiziger, de	traveler
rekening houden met	take into account
rekening, de (bankrekening)	account
relatie, de	relationship
relatief	comparative
rennen	run
reparatie, de	repair
repareren	repair
reserveren	reserve
respect, het	respect
restje, het	remnant, leftover
resultaat, het	result
retour	two-ways
rij, de	queue
rijbewijs, het	driving license
rijk	rich
ritueel, het	ritual
rivier, de	river
roerbakken	stir-fry
roeren	to stir
rol, de	role
rond	round
rondom	around
rook, de	smoke
rot	lousy
rug, de	back
rugzak, de	backpack
ruilen	return
ruim	spacious, roomy
ruimte, de	room, space
rust, de	rest
ruzie, de	argument
saai	boring
saldo, het	balance
samen	together
samenleving, de	society
samenstellen	compile
samenvatting, de	summary
sap, het	juice
schaatsen	to skate
schade, de	damage
scheiden	divorce
schelden	to curse, to swear, to call names
scheppen	to scoop, to shovel
schijnen	shine
schilderen	paint
schilderij, het	painting
schildpad, de	turtle
schillen	to peel
scholier, de	student
schoonhouden	clean
schoonmaken	clean
schoonmoeder, de	mother-in-law
schoonvader, de	father-in-law
schoonzus, de	sister-in-law
schouder, de	shoulder
schrifterlijk	in writing
schrijver, de	writer
schrikken	to be scared, to be shocked
schuld, de	debt
scooter, de	scooter
secretaresse, de	secretary
selecteren	select
serie, de	series
serieus	serious
service, de	service
sigaret, de	cigarette
sinaasappel, de	orange
sinds	since
situatie, de	situation
slaan	to hit
slag, de (aan de slag gaan)	get to work
slagen	succeed
slagen (voor een examen)	pass
slang, de	snake
slank	slim
slap	weak, spineless
slapen	sleep
slechts	only
slee, de	sled, limo
sleutel, de	key
slinger, de	garland, paper chain
slingeren	to meander
slok, de	swallow, sip
sloom	lethargic, slow
slot, het	lock
sluiten	close
smaak, de	taste
sneeuw, de	snow
snipperen	to shred
snoepen	eat sweets
snuiten (neus)	blow (your nose)
soep, de	soup
solliciteren	apply for
somber	gloomy, pessimistic
sommige	some, certain
souvenir, het	souvenir
sowieso	in any case
sparen	save
speciaal	special
specialiteit, de	speciality
spectaculair	spectacular
speelplaats, de	playground
spel, het	game
spelen	play
spiegeling, de	reflection
spier, de	muscle
spier, de	muscle
spoedgeval, het	emergency
spontaan	spontaneous
spreekuur	consultation hours
spreekwoord, het	proverb
springen	to jump
spruitjes, de	Brussel sprouts
spullen, de	things
staart, de	tail
staat, de	condition
stand, de	position
stank, de	stench, nasty smell
stap, de	step
starten	to start
steeds	always
stelen (gestolen)	steal (stolen)
stellen	to imagine
stelling, de	posing
stem, de	voice
ster	star
sterk	strong
sterkte	take care
sterven	die
steun, de	support
stevig (onweersbuien)	severe (thunderstorm)
stichting, de	foundation, non-profit
stijgen	to increase
stijl, de	style
stil	silent, quietly
stilstaan (stilstaand verkeer)	stuck in traffic
stilte, de	silence
stimuleren	to stimulate, to encourage
stinken	to stink, to smell
stip, de	dot, point
stofzuigen	to vacuum
stom	stupid
stoppen	stop
storm, de	storm
stoven	to simmer, to stew
straf, de	punishment, penalty
strand, het	beach
streek, de	region, area
streep, de	line
streng	strict
strijken	to iron
stromen	to pour, to flow
structureel	structural
stuk(je), het (per stuk)	piece
sturen	send
succes	success
succesvol	successful
super	super
symbool, het	symbol
tabak, de	tobacco
tablet, de	pill
takelwagen, de	tow truck
tandenpoetsen	to brush your teeth
tante, de	aunt
technisch	technical
tegel, de	tile
tegenkomen	to encounter
tegenligger, de	oncoming traffic
tegenover	opposed
tegenwoordig	nowadays
tekenen	draw
tekort, het	deficit, shortfall
tekortkomen	to lack
telefoniste, de	phone operator
teleurgesteld	disappointed
televisie, de	television
temperatuur, de	temperature
ten slotte (tot slot)	finally
tenminste	at least
tenslotte	finally
tentoonstelling, de	exhibition
ter plekke	on site
terecht	advice
terechtkomen	to end up
termijn, de	period, term
terras, het	terrace
terug	back
teruggaan	to go back
terughebben van	get change
terugkomen	come back
terugkomen	to come back, to return
terwijl	while
test, de	test
tevreden	satisfied
theoretisch	theoretical
theorie, de	theory
thuiskomen	come home
thuiszorg, de	home care
tijdelijk	temporary
tijdschrift, het	magazine
toekomst, de	future
toen	when, then
toenemen	to increase, to grow
toespraak, de	speech
toetje, het	dessert
toets, de	test, check
toevoegen	to add
tolerant	tolerant
totaal	total
totdat	until
traan, de	teardrop
traditioneel	traditional
trap, de	stairs
trekken	take
trend, de	trend
triest	sad, depressing
trillen	to tremble
troep, de	trash
trots	pride, proud
trouw	faithful
trouwens	by the way
tweedehands	secondhand
tweeling, de	twins
type, het	type
ui, de	onion
uitbreiden	to enlarge
uitdoen	to turn off
uitdrukken	express
uitdrukking, de	idiom
uiteindelijk	eventually
uitgang, de	exit
uitgave, de	expense, cost
uitgeven	spend
uitlaten	to take out
uitleggen	explain
uitmaken	to matter
uitmonden	to flow out
uitpakken	to unpack, to unwrap
uitslijten	to erode
uitspreken	pronounce
uitvaart, de	funeral, burial
uitvallen	to malfunction, to fall out
uitverkockt	sold out
uitwisselen	to exchange
uitzendbureau, het	temporary employment
uitzondering, de	exception
uniek	unique
uurloon, het	hourly wage
vaas, de	vase
vaatje, het	small barrel, keg
vallen	fall
vangen	to catch
vanzelf (dat gaat vanzelf over)	itself (dat will be over by itself)
vast	fixed
vast (vaste relatie)	steady relationship
vechten	to fight
veilig	safe, secure
veiligheid, de	security, safety
ver	far
veranderen	change
verantwoordelijk	responsible
verbazen, zich	to amaze, to astonish
verbergen	to hide, to conceal
verbieden	to forbid
verdelen	to divide up, to distribute
verdienen	earn
verdrietig	sad
verdrinken	to drown
verdwijnen	to disappear
vereniging, de	club, association
vergadering, de	meeting
vergelijken met	compare with/to
vergeten	forget
vergoeden	to reimburse
vergrijzen	to age
vergrijzing, de	ageing
verhaal, het	story
verhitten	to heat
verhuizing	move
verkeer, het	traffic
verklaren	explain
verklaring, de	explanation
verkopen	sell
verkouden zijn	have a cold
verkruimelen	crumble
verlaten	to leave, to get off
verleden, het	past
verlegen	shy
verlengen	to prolong, to extend
verliefd	in love
verlies, het	loss
vermijden	avoid
verpakking, de	wrapping
verpleegkunde, de	nursing
verplicht	compulsory, obligatory
verrassen	to surprise
verrassing, de	surprise
verschijnen	appear
verschil, het	difference
verschillend	different
verschrikkelijk	terrible
versieren	to decorate
verslaafd	addicted
verstaan	(to be able) to hear
verstoren	to disturb, to upset
versturen	send
vertalen	translate
vertaling, de	translation
vertellen	tell
vertrekken (vertrek, vertrekt)	to leave
vertrouwd	reliable, trustworthy
vertrouwen, het	confidence, trust
vervanger, de	replacement, substitute
vervelen	annoying
vervoer, het	transport
vervolgens	then
vervuiling, de	pollution
verwachten	expect
verwachting, de	expectation
verwennen	spoil, pamper
verwerken	to process, to handle
verwijnzen	refuse
verwijsbrieven	refer
verzamelen	collect
verzekeren	to insure, to ensure, to assure
verzorgd	neat
verzorgen	to care for, to look after
verzorger, de	caretaker
verzwakt	weakened
vezel, de	fibre
vies	dirty
visite, de	guests
vlag, de	flag
vlak	flat, level
vlakbij	nearby
vliegen	to fly
vliegtuig, het	airplane
vloeiend	fluent(ly)
vloeken	to curse, swear
vloerbedekking, de	floor covering
vlucht, de	flight
vocht, het	liquid, fluid
voeding, de	nutrition, feeding
voertuig, het	vehicle
voet, de	feet
vogel, de	bird
voldoende	sufficient
volgorde, de	order, sequence
volhouden	hold on
volk, het	people
volop	in abundance
volwassene, de	adult
vooraf	beforehand, in advance
vooral	especially
vooral	especially
voorbereiden	prepare
voordelig	advantageous, profitable
voorgoed	once and for all
voorhoofd, het	forehead
voorhoofd, het	forehead
vóórkomen	to occur
voorlopig	for now
voornamelijk	mainly
vooropleiding, de	preliminary training
voorschrijven	prescribe
voorstelling, de	show, performance
voorverwarmen	to preheat
voorwaarde, de	condition
voorzichtig	careful
vorig	last
vraagprijs, de	asking price
vreemd	foreign, strange
vreselijk	terrible
vriendenprijsje, het	friendly prices
vriendschappelijk	friendly
vriezen	freeze
vriezer, de	freezer
vrijgezel, de	bachelor
vrijheid, de	freedom
vrijwilliger, de	volunteer
vroeger	in the past
vrolijk	cheerful
vuil, het	garbage, foul
vuilnisbak	dustbin
vuur, het	fire
waaien	blow
waarde, de	value, worth
waarheid, de	truth
waarschijnlijk	probably
waarschuwen	to warn
wandelen	walk
wandeling, de	walk
wang, de	cheek
wasmiddel, het	detergent
wassen	wash
weduwnaar, de	widower
weersverwachting, de	weather forecast
weg moeten	have to go
wegen	weigh
wegens	because of
wegenwacht, de	AAA roadside service
weiland, het	pasture
weinig	few, little
weinig - minder - minste	a few
wekker, de	alarm
wel eens	ever, sometimes
wennen aan	get used to
wereld, de	world
werknemer, de	employee
werkzaamheden, de	duties
westen, het	the west
wet, de	law
wetenschappelijk	scientific
wettelijk	legal, statutory
wijzen	to point
wijzen (wijs, wijst)	point out, show
winkelen	to shop
winnen	to win
wisselvallig	changeable
wok, de	wok
wolk, de	cloud
wolkenvelden, de	cloud bank
zaak, de	shop
zacht	soft, gentle
zak, de	bag
zakgeld, het	pocket, spending money
zakken	to fail (for an exam)
zalig	gorgeous, divine
zand, het	sand
zanger, de	singer
zee, de	sea
zeep, de	soap
zeer doen	hurt
zegeltjes, de	trading stamps
zelf	self
zeuren	nag
zich ergeren aan iets	annoyed by
zich haasten	hurry
zich vervelen	be bored
zich voelen	feel
ziek	sick
ziekte, de	illness
zilver	silver
zin, de	sentence
zingen	sing
zo'n	such a, about
zoals	as, like
zodat	so (that)
zodoende	in this/that way
zoen, de	kiss
zoenen	to kiss
zoiets	something
zolang	meanwhile
zomaar	just like that (without warning)
zorg, de	care
zorgen (zich zorgen maken over)	worry about
zorgen voor	provide
zorgzaam	caring
zowel ... als	both... and
zuchten	take a deep breath
zuiden, het	south
zulk	such
zwaar	heavy
zwager, de	brother-in-law
zwanger	pregnant
zwemmen	to swim
