1 time qaangiummat	1 hour passed / later
30-ukiulik	30-year-old
50-iliivoq	celebrates its 50th birthday, turns 50
aajutigalugu	at the same time that he found it
aak	blood
aalajangerpoq, isummiuppaa	to decide
aali!	cool!
aalisagaq	fish (animal)
aalisariut	fishing boat
aalisarpoq	to fish
aalisartoq	fisherman
aallarnerpoq, aallartippoq	to start
aallarpoq	to run, to be in progress, to be in session, to take off, to leave
aallartippoq	to begin
aammalu, aammalumi	furthermore, in addition to that
aamma, -nerusoq	more (adj.)
aamma, -qqippoq	again
aanaarpoq	to bleed
aanaq	grandmother
aapaluartoq	purple
aapaluaruk	flamingo
aappaa, nassarpoq	to bring
aappalaarpoq	blood red
aappallarippoq	bright red
aappallarissoq	scarlet
aappalujappoq	pink
aappalukujuppoq	dark red
aappaqanngilanga	I'm not married (said by a woman)
aapparaa	is his companion, is his spouse, goes with him
aappariinneq	marriage
aappariit, aappariik	couple, comrades, husband and wife
aappersariaq	consonant
aappilarujuttoq	pink (alt.)
aaqqatit	gloves
aaqqippaa	to bring something in order
aarluarguk	dolphin
aarluk	orca whale
aasaq	summer
aasiak	spider
aataaq	harp seal
aataq	grandfather
aatsaarpoq	yawns before sleep
aatsaat	just now, right now
aavaa	fetches it, goes after it
a bad road	aqqutipalaaq
a crowd of people	inuppassuit
affaku	scrap, remnant
affaq	1/2
affarleq	separate comparment
affassak	an almost seperated part
aggerfik	way, path
aggerpoq	approaches, is underway, comes
aggiuppaa	brings it
aggiut	day of arrival
aggoqatigiissillugit	on average
agguaaneq	division (math)
agiaq	violin
agiorpoq	to rub, to play the violin
agurki	cucumber
ajak	mother's sister
ajassaatit	fork
ajomaangilaq	it is possible
ajornanngitsoq	possible (adj.)
ajornortorsiut	problem
ajugaaffigaa	he defeats him, he wins against him
ajugaaniunneq	contest
ajugaaniutivinneq	finale
ajugaavoq	to win
akaaraa, iluaraa, nuannaraa	she likes it
akeqanngitsoq	free (as in costing no money)
akeqarpoq	cost (verb)
akiani	across from something, on the other side
akilerniarlugu oqarpunga	I said I wanted to pay it
akiliivoq	to pay
akisaasaq	cushion
akissut	answer (noun)
akit	pillow
akkak	father's brother
akornanni	among
akornanni	in total, in all
akuerara	I accept it
akulikitsumik, -gajuppoq, -rajuppoq, -kkajuppoq, -kulaarpoq	often
aleqa	a brother's older sister
alersit qarlittallit	tights
alersit	socks
aliasungaarneq	sorrow
aliasunneq	sadness
alla, aappaa	other (adj.)
allaaserisap oqaasertai	text
allaat, kuglepenni	pen (writing utensil)
allaffik	office
allaffimmioq	clerk
allagarsivoq	gets a letter
allagartaq	sign (n.)
allakkat iluartut	the Holy Scriptures
allakkat	writings, books, book, letters, letter
allakkerivik	post office
allak	stripe, spot
allaq	bear
allarterivoq	to dry the dishes
allarut	towel
allatsi, sekretæri	secretary
allattarfissuaq	whiteboard
allattarissat	written exercise(s)
allattuiffik	list
allattuivoq	to list
allunaasaq	rope, cable, line, string
alusaat	spoon
alussaateeraq	teaspoon
Alutornaq!	Great! Magnificent!
alutornartorsuaq, tupinnartoq	it is big, it is great
Amaarpit?	Are you drunk?
ameerpaa	he skins it
ameq	skin (n.)
Amerika Avannarlermi	North America
Amerikkami Naalagaaffeqatigiit	USA
amerlasuut, ikattut, -passuit	many
amerlisaaneq	multiplication
ammalortoq	round (adj.)
ammarpaa, ammarpoq, mapperpoq	to open
ammorluinnaartoq	vertical
amusariaq	dresser
aneqqajanngitsoq	long before he went
angajoqqaat	parents
angaju	a brother's older brother
angaju	a sister's older sister
angak	mother's brother
Angalalluarina!	Bon voyage!
angalaneq	"journey (also ""traffic"")"
angalaneq	traffic
angalavoq	to travel
angerlaqquaa	she asked him to come home
angerlarpoq	he goes home
angerlarsimaffik	home
angivoq	it is green, it is big
angusiniaqatigiit	Interest Group (political)
angutaatiga	my boyfriend
ani	a sister's older brother
anijaarpoq	to leave early
anijaarpoq	to leave early
anillarsinnarluni	after having went out
aningaasanngukkat	cash
aningaasat	money
aningaasat tigoriarlugit anivunga	I took money and went out
anivoq	he went out
annermik, -nerusumik	most
annersippaa	he hurts it
anniarpunga	I feel pain
annippaa	to muck up something
anorersuarpoq	stormy
anorlerpoq	windy
apeqqut	question
apersorneqarpoq	is interviewed, is questioned, is interrogated
a piece	-mineq, -mernit, -merngit
apivoq	it has been snowing
appaliarsuk	little auk
appelsiina	orange (fruit)
appippoq	breaks out in song, begins to tell, sings
aput	snow (n.)
apuuppoq	he reached his destination
aqaguagu	the day after tomorrow
aqagu	tomorrow
aqerluusaq	pencil
aqisseq	ptarmigan
aqqaluk	a sister's little brother
aqquserngup aqqa	street sign
aqqusineq	road
aquppoq	he operates
aquttoq	ship's officer
Araabiamiuarangavunga?	Do I look a little Arab?
Araberi	Arabian
arfininngorneq	Saturday
arfivik	bowhead whale
arlaannik najorsimaiassagut	we'll have something to drink
arnaatiga	my girlfriend
arpappoq	to run
Arriitsumik oqalulaalit	Please speak more slowly
arsarneq	football (not American football)
arsarnerit	Northern Lights
artornanngitsoq	easy
asaasartoq	cleaner
asanninneq	love (n.)
asappoq, errorpaa	wash (intrans. / trans.)
aserfallatsaaliorpaa	she maintains it
aserfallatsaaliuineq	maintenance
aserorpoq, aseruivoq, napivaa, -iarpoq	to break
aserorterpaa	he crushes it
asks him to leave	aneqquaa
assaap inuaa	finger (two words)
assaassut, assaassuaq	excavator
assaavoq	to dig
assagiarsuk	shore crab
assak	hand (noun)
assammik-arsaanneq	handball
assappaa	he excavates it
assartorpaa	"he hauls it (also ""he transports it"")"
assartorpaa	to transport
assartuut	means of transportation
asseq	photo
assigiinngitsut, allatut ittoq	different
assigiit	identical
assiliaq	picture (n.)
assiliivoq	to take a picture
assinga	similar (adj.)
assut	a lot
assut	much (also: a lot)
assut!	quickly! come on!
assuunngitsumik!	gently!
ataani	downstairs, underneath
ataasersiut	singular
ataasinngorneq	Monday
ataatsimiinneq	meeting
ata!	exclamation to call attention
atagu!	one moment!
atavoq	it exists (starts with an a)
ateq	name
atequt	skirt
ateraasat	slippers
atisaasivik	closet
atisaat	clothes, clothing
atisalersorpoq	to get dressed
ativaa	she puts it on
atoqatigiipput	they have sex
atorfissaqartippara	I need it
atorpaa	"to exploit (also ""to use"")"
atorpaa	to use
atorpoq	to borrow
atortortup igalaasartaa	screen (on an electric appliance)
atoruminaappoq	is difficult to pass through
atoruminaatsoq, artornartoq	difficult
atsak	father's sister
attartugaq	cargo ship
attorpaa	touches it
atuagaasivik	bookshelf
atuakkanik atorniartarfik	library
atualerpoq	he's beginning school
atualinngikkallarmat	before he began school
atuarfik	school
atuartitsivik	classroom
avaalaqiaq	dwarf birch
available, acquired	-ut, -utit
avalaappaa	to take someone out to sea, to take someone dancing, to the dance floor
avammut, silamut	out
Avataa sila qanorissava?	What sort of weather will be at sea?
avatangiisit	environment
aveqatigiippaat, -qatigiipput	to share
aviisimut ilanngutassiaq	newspaper article
avinneruvoq	is divorced
a worn-out boot	kamikoq
bad, has a bad X	-luppoq, -luttoq, -rluppoq, -rluttoq
bad, miserable	-palaaq, -palaat
bankimiippoq	he's in the bank
bankimiissinnarlunga kalaaliaqqamukassanga	I'll go to the bank and then I'll go on board
became a(n) X	-nngorpoq
before he eats	nerisinnagu
before	-tinnagu, -stinnagu
believes that he/she...	...soraa, -sorinnippoq
big, chubby, oversized	-suaq, -suit
big ground, crowd (plural only)	-passuit
big room	inersuaq
biilerpoq	to drive a car
biologi	biologist
børstit	brush
built a house	illuliorpoq
busserpoq	to take the bus
bussip unittarfia	bus stop
but, however	-aluarpoq, (-g, -kk, -r)
causes, so that one is/does	-narpoq
celebrates Christmas	Juullisiorpoq
cheap	akikippoq
citroni	lemon
coffee on hand	kaffiut
cozy little room	ininnguaq
did something to him/her	-figaa
did something X times	-riarpoq
does exclusively	-innarpoq, -ginnarpoq
does/is too much	-pallaarpoq, -vallaarpoq (v-stem)
does no longer	-naveerpoq
does often, with pleasure	-ajuppoq, (-g, -kk, - r)
does something together with him/her	-qatigaa, -qatiginnippoq
does something with someone else	-qat, qatit
does temporarily	-allarpoq, (-g, -kk, -r)
doll	inuusaq
"do well, positive(ly) (one ""l"" when preceded by ""r"")"	-lluarpoq, (+r = -luarpoq)
dump, eqqavik	dump (noun)
dumperi	dump truck
during	-tillugu, -stillugu
eating table (vik + mid-consonant = mid consonant is toubled.)	nerrivik
enormous dog	qimmerujussuaq
enormous	-rujussuaq, -rujussuit
eqeerpoq	it stays awake
Eqeqqukikequtima Kukikequtaa	the reason for a small nail in my pinky
eqiasuppoq	he's lazy
eqqaamavaa	to remember
eqqaani	nearby
eqqanaq!	exclamation of dismay
eqqarsarpoq	he thinks, speculates
eqqartuussisut, eqqartuussivik	court (legal place)
eqqoq	butt (anatomy)
eqqorpaa, unatarpaa	he hits it
eqqortoq	it is right, it is correct
eqqumiitsuliorneq	art
eqqusaq	sea urchin
equlussuaq	shark
equutissaq	toilet paper
erfalasoq	flag
eriagaa	protects it, conserves it
erinarsorpoq	to sing
eriniinnaq	soon
ermippoq	wash one's face
erneq	son
erniinnannguaq	very soon
erniinnaq	soon
ernumagaa, isumakuluutigaa, kappiagaa	to worry
ernumavoq	is worried, is anxious
-erpoq, ingerlatippaa	to drive
errorsissut	washer
errorsivoq	to do laundry
errortassat	laundry
erruissut	dishwasher
erruivik	sink
erruivoq	"to do the dishes (as well as ""to wash up"")"
erruivoq	wash up
erseqqarippoq	clear
ersersippaa	to show
ersigaa, qunugaa	to fear something
ersineq	fear (noun)
ersisoq, annilaangavoq	afraid
ersiut	vowel
fjernsynerpoq	to watch TV
Fjernsynimi unnugu soqarpa?	What's on TV tonight?
formerly	-koq, -kut
future indicator (e.g. to be shown, to be demonstrated)	-ssaq, -ssat
-gami, -rami, -mat	because
geologi, ujarassiooq	geologist
gepardi	cheetah
gets, buys, finds, meets	-sivoq
gets medicine	Nakorsaatitorpoq
goes to...	-iartorpoq, (-g, -kk, -r)
goes to take a bath	uffariartorpoq
got a new X	-taarpoq, -staarpoq
got X pieces	-raarpoq
Grækeri	Greek person
Grækerit Nunaat	Greece
Grækerit Oqaasii	Greek Language
-guni, -kuni, -pat	if
had a new daughter	panissaarpoq
had/is more, further	-qqippoq
had not X, although he/she should have	-nngitsoorpoq
has bad boots	kamilluppoq
has (only) a bit, few, small (of) X	-kippoq
he became a doctor	Nakorsanngorpoq
he becomes seen	takuneqarpoq
he believes that she understood	paasisoraa
he came, but...	tikikkaluarpoq
he came here two times	marloriarluni tikippoq
he did not come as planned	tikinngitsoorpoq
he got five (of them)	Tallimaraarpoq
he is from Nuuk	Nuumminngaaneerpoq
he left, but he'll be back soon	anigallarpoq
helikopteri, qulimiguulik	helicopter
he never eats meat	neqitujuippoq
he often catches game	angutaannarpoq
he only hurries (up)	tuaviinnarpoq
he quickly learnt	ilikkapallappoq
he sleeps well	sinilluarpoq
hiisterpoq	to ride a horse
hiisti	horse
homemade pastry	kaagiliaq
hotelli	hotel
How big is...?	Qanoq angitigiva?
How long?	qanoq sivisutigisumik?
"How? So...as... (used with ""qanoq"" or ""ima"")"	-tigi
hurried up and did X, quickly did X	-pallappoq
iffiaq qaqortoq	bread
iffiaq	rye bread
iffior-	to bake
igalaaq	window
iga	pot (cooking)
igasoq	cook (person who cooks)
igavoq	he cooks
iggavik	kitchen
igippaa, eqqarpaa	to throw away
igutsak	bee
iigaq	wall
iipili	apple
ikaartarfik	bridge
ikani	there
ikiaqut	vest, undershirt
ikilerpoq	it hurts
ikinngut	friend
Ikinngutinnersumik	"Please (like ""s'il vous plait"")"
ikinngut(it)	friend(s)
ikiorti	assistant
ikippaa	turns on
ikitsivoq	to turn on
ikiui-	to help
ikiulaannga!	help me, please!
ikiuuppoq, ikiuivoq, saqivoq	to help
ikivaa	he puts it
ikuallappoq	to burn
ikumavoq	is on
ikusik	elbow
ilaa, areali	area
ilaajuarpoq	he always travels with him
ilaanni, ilaannikkut, ilaatigut	sometimes
ilaannik	any
ilaannikkut	sometimes, once in a while
ilaasartaat	passenger ship
ilaat, ikittunnguit	some, quite a few
ilaavoq	"he is with, he is participating, (Dan. ""er med"")"
ilanngaaneq	subtraction
ilaquseq	hedgehog
ilaqutakka	my family
ilaqutaq	family member
ilaqutariit, ilagisat	family
ilatooq	member, limb
ilimanartoq	probable, likely
ilinniarpoq	"to do homework (as well as ""to learn"")"
ilinniartitsisoq	teacher
ilinniartitsisukkunnukassaagut	we're going to visit the teacher's family
ilinniartoq	student
iliorpoq, suliaraa	to do
ilisarsiniut	article (grammar)
ilisima-	to know
ilisimatooq	scientist
ilisimatusarfik	university
ilisimavaa	he knows him
ilissiuku	belonging to all of you (pl.)
ilissiuna	belonging to all of you (sin.)
Ilissi?	You, sir / ma'am? (can I do anything for you?)
ilitsivik	shelf
ilitsoqqussaq	tradition
ilivaa, iliorarpai	to put, to lay something somewhere
ilivitsoq, tamaat	whole (adj.)
illaagutit	comb
illaarpoq	to brush hair
illar-	to laugh
illersorpaa	he protects it
illinukku	yours (pl.)
illinuna	yours (sin.)
illit piga	your (adj.)
illoqarfiit pingaarnersaat	capital city
illoqarfik	town
illoq	cousin
illuarpaa, nuuppaa	to move (trans.)
illumi sulineq	housework
illup uigua	wing (section of a building)
illu qisuuvoq	the house is made of wood
iluanaarpoq	has luck, is lucky
iluani	inside
Iluanngik	(You are / he is) not too smart
iluaqutigisinnaaviuk?	have you any interest in it?
iluarsaappaa, aaqqippaa	to fix
iluarsaappaa, iluarpaa	to repair it
Iluarsilluarina!	Get well soon!
Iluatitsilluarina/risi	Good luck (sin. / pl/)
iluliaq	iceberg
ilumoortoq	true
ilumut	it is right, it is indeed, it certainly is (followed by something)
ilupaqutit	underpants
iluseq	shape (n.)
imangertaq	bat
imaq	sea
imarsiortoq, umiartortoq	seaman
imerpoq, -torpoq	to drink
imertarfik	glass (cup)
imerusuttoq	thirsty
imigassaq	spirits (alcohol)
imigassartorsimanermut misilitsinneq	alcohol test
imigassat	a drink, drinks
immiaq, baaja	beer
immikkoortoq	part (n.)
immikkoortortaq	paragraph, snippet
imminut neruuppoq	self respect, he offers his help
imminut	oneself
immut	shell, wrap, self
imuk	milk
imussuaq	cheese
inaarpaa, naammassivaa, naavaa	to finish
inatsisiliortut, inatsisartut	parliament
inatsit (pl. inatsisit)	law, rule
ineriartorneq	development
ineriartortippaa	he develops it
inermiutarsuaq	hippo
inerpoq	to be over, to grow up fully
inersimasoq	adult
inersuaq	living room
inerterpai taama oqaloqqunagit	he forbade them to speak like that
ingeniøri, maskinmesteri	engineer
ingerlaarneq	parade, procession, wandering, hike, being underway
ingerlatsivik	company (business venture, firm)
ini	room
ini silarleq	outer space
inissiaq	apartment, dwelling
inissiarsuaq, initalik	apartment block
inituvoq, immerpaa	to fill
innaallagisserisoq	electrician
innaarsuk, ippik	cliff
-innar, -ginnar (after -aa or -ii)	right after having (verbed)
innarpoq	to go to bed
innartorpoq	to climb
inngigissaat	pencil sharpener
inooqatigiit	community
inorlugu	under
inortuivoq	to be late
inuak	finger (one word)
inuak	toe (one word)
inuiaat	people
inuiaqatigiinni ilisarnaqut	coat of arms
inuiaqatigiit	society
inuigatigiinni erinaq	national anthem
inuit amerlanerit naluaat	the public is unaware of it
inukkat, nallukattat	cards
inunngorfik	birthplace
inunngorpunga	I was born
inussiarnerpoq	he is friendly
inussiarniippoq	he is unfriendly
inutuussuseq	population
Inuuneq asaguk inuunerup asammatit.	Love life, because life loves you.
inuusuttoq	young
ippappoq	became dirty
ippassaani	the day before yesterday
ippassaq	yesterday
ippoq	it exists (starts with an i)
is a bit big	angilaarpoq
isarukitsoq	penguin
iseriallarami taavaana...	then he came in, so...
iserneq	entry, entry fee
iser-	to come in
isertuussaq	secret
is exactly	-piarpoq, -rpiarpoq
is forbidden	-qqusaanngilaq
is from	-minngaaneerpoq
is further behind	uteqqippoq
is, has a little, is a bit, has a bit	-aarpoq, -laarpoq
isi	eye
isigaa, isiginnaarpaa	to watch
isigaa, nakkuppaa	she looks at it
isigak	foot
isiginnaarut	TV
isikkani kasuussaatiitigalugit	while he bumped his feet together (to get warm)
isikkap inuaa	toe (two words)
isikku	appearance
Isissutissat nungupput	sold out concert
isissutissat	tickets
is not, is un-	-ippoq
is not pretty	kusanaappoq
is nowhere on the beach	sissamiinngivippoq
is nowhere there	-miinngivippoq
issiavik	chair
issiavissuaq	armchair
issiavoq	to sit
issi	cold
issingiassartorpoq	to eat oatmeal
issingigassat	oatmeal
issippoq	it is cold (i)
issuq	earth
is tiring	qasunarpoq
is too tired	qasuvallaarpoq
isugutanarpoq	humid
isumaqataavoq	age (of a person, or thing)
isumaqataavoq	to agree
isummersuivoq	he gets ideas, he has ideas, he inspires, he gives council
iterpoq	to wake up
it is exactly 1:00	ataasinngorpiarpoq
it is good, it has X good/well	-gippoq, -rippoq
itisooq, qinngortooq, qatitooq	it is deep
it's not all that bad	ajorpianngilaq
ittoorneq	humility, shame, self-deprecation
ivikkanik sapigaqarpunga	I'm allergic to grass
ivik-	to grow
Japanimiutuut, Japanimiu	Japanese
Jensi Evamut takoqqulluni nikuippoq	Jens travelled so Eva could see him
-juma, -kuma	in order to ~ (verb)
just one day	ulluinnaq
kaagiliorpoq	to bake (starts with k)
kaajallallugu, missaanni	around
kaattarpoq	he bangs with a hammer
kaattoq	hungry
kaffiliorpoq	to make coffee
kaffilissaanga	I'm going to hold a Kaffemik
kaffisoriatussaanga	I'm going to a Kaffemik
kaffisorpoq	he drank coffee
kaffisuutigalunga aviisi atuarpara	I read the newspaper at the same time that I drank coffee
kajortoq	brown
kakaavi	cocoa
kakkattutit!	you are good (at something)!
kakkilertasoq	runny nose
kalleq	thunder
kamattoq	angry
kamippak	boot
kammak	buddy
kanajoq	sculpin
kaneq	frost
kangerluk	fjord
kanngorooq	kangaroo
kanni	pitcher
kapisilik	salmon
-kasik	of bad quality (suffix)
kasuussaappai	he bumped them against each other
katappaa, tammarpaa, annaavaa, ajorsarpoq	he loses (it)
~ katappara	I lost my ~
katappoq	it falls off
katersortarfik	community center
katersugaasivik	museum
katersuineq	collection
katinngikkallaratta	before we were married
katippoq	to get married
katippugut	we are married
katitsineq	addition (math)
kattut	conjunction
kavaajaq	coat
key	matuersaat
kiak	warmth
kiap	whose
kiassartoq, kiattoq	hot
kiassuseq	heat, temperature (when referring to outdoor heat)
kicks him out	anisippaa
kiffaanngissuseq	freedom
kiffaanngitsoq	free (as in politically)
kiggioq	beaver
kiguserineq	toothache
kigutaarnaq	blueberry
kigutigissarpoq	to brush one's teeth
kigutilissuaq	sperm whale
kigutinut saligut	toothbrush
kigutit-nakorsaat, kigutilerisoq	dentist
kigutit qaqorsaataat	toothpaste
kigut	tooth
kiinaq	face
kiinarsivaa	to meet someone or something for the first time, when one has only heard of the name
kilerneq	cut (noun)
kilerpoq	to cut oneself
kilisaat, trawleri	trawler
killoq	wrong
kimmernaq	lingonberry
kinaassuseq	identity
kingornagut	after
kingornagut, kingunerileraa, tamatuma kingorna, pissutigalugu	since
kingullermik	last (adj.)
kingumut qiviarneq	flashback
kingusissoq	late
kisiat	just him/her, just it, by him/herself
kisitsit	number (n.)
kisitsivoq	to count
kissarneqarneq	fever (long form)
kissarni	fever
kissarpoq	to wish
kissarsuut	stove
kissavaasaq	scallop
kivippaa	to lift
kjole	dress (noun)
-kkut, tigut	through
klaveri, pattagiaq noqartilik	piano
klima, silap pissusia	climate
kommune	municipality
koori	laundry basket
kristumiut	Christians
kukkukooq	rooster
kukkuneq	mistake
kulturikkut illorsuaq	cultural center
kunngi-arnaq	queen
kuserpoq	drips
kutsiorfigaa	he asks him for help
kuuguaaq	cougar
kuuguaaq	cougar
kuuk	creek, river
kuukkuooriarsuaq	crocodile
kuusuaq	big river
kuutsitsilluni uffarfik	shower (n., like taking a shower)
lastbilimik ingerlatitsisoq	truck driver
lastbili	truck
leaves more often	anigajuppoq
likes doing, does often	-taannarpoq, -staannarpoq
-li, kisianni	however, but
-llarsinnar-	after having (verbed)
-llatsiaannar	after having (verbed) for a short time
looks like, as if	-paluppoq, -rpaluppoq
looks like he left	anerpaluppoq
maani, tamaani, uani	here
maannakkorluinnaq	instantaneously
made	-liaq, -lissat, -liat
made of	-taq, -tat
made of wood	qisutaq
majuartarfiit	stairs
makiaarpoq	to get up early
makippoq	to get up
makkortippaa, toorpaa	to click, to press (buttons, etc.)
malik	wave
malippaa, malinnippoq	to follow
malittarisassaq, maleruagassiaq, ileqqoq	rule
malugaa, savippaa	to feel something
malunnarpoq	is noticeable, can be sensed or felt
manik	egg
manna, taanna, tamanna, una	this (pronoun)
marloraaq	hen
marloriarluni tikippoq	he came here two times
marlunngorpoq	it is Tuesday, it is 2 o'clock
marlussaq	something that is one, but can be made into two
marluullutik	both of them
massakkorluinnaq	right now
matuaa	to close
matu	door
matungajalersoq iserpoq	he came in right before it closed
matuvoq	it is closed
means, tool, agent, does X	-saat, saatit
meeqqerivik	kindergarten
meeraaqqerivik	nursery
meeraateqarfik	child care center
meets/finds people	inussivoq
mekanikeri	mechanic
meqqanut aapakaat takoqqullugit uumasuusivimmukarpugut	we went to the Zoo so the kids could see the monkeys
meriannguneq	sickness (usually seasickness)
mersorpoq	to sew
middle-sized glacier	sermitsiaq
middle-sized	-tsiaq, -tsiaat
-miit, -niit	off, off of
mikisoq	little
-mik paasisinneqarpoq	became informed about ~
-mik pisariaqartitsivunga	I deserve -
-mik pisinnavunga	Can I order a - ?
milakulaaq	jaguar
milinngatsivoq	stuffy nose
miloriarpoq	to throw
miluumasoq	mammal
miseraq	sauce
misigaa	he feels it
misigisaq	experience (or something one experiences)
misiligaa	he tries
misisuivoq	to explore
miteq	elder
-mit, -mik, -nit, -sunit, -p	of
mittarfik	airport
mobili	cellphone
mobili, oqarasuaat nassartariaq	mobile telephone, cellphone
moves in the direction of X	-mukarpoq, -nukarpoq
moves to Nuuk	Nuummukarpoq
-mut	for
-mut, -nut	to
...-mut piareerpugut	We are ready for ...
naaja	seagull
naakkinniuippoq	is hard-hearted, is merciless
naalagaq	boss (n.)
naalakkersuisut	government
naalappoq	listens, obeys
naallugu atuarpaa	he reads through it
naamavaa	he can smell it
naammaappoq	it fits, it is the right size (for a garment, etc)
naapippaa, misigisaqarpoq	he meets her
naapi-	to meet
naarlunneq	stomachache
naasoq	plant, flower
naasorissaasoq	farmer
naasulivimmi naasoq	potted plant
naatsiiaq, katorfili	potato
naatsoq, -kitsoq	short
naatsorsuusiortoq	accountant
nagguaatsoq	elephant
naja	a brother's little sister
najugaqarpoq, nunaqarpoq, inuuvoq, uumavoq	it is alive
nakkar-	to fall down
nakkoriippoq	cannot get along with people, is disagreeable
nakorsaq	doctor
nalaasaarfik	sofa
nalavoq, innangavoq, aqupivoq	to lie down
nalinginnaq	common
nalunaaqutaq	clock
nalunaarasuartaatilioqateeraliorfinnialikkersaatiginialikkersaatilillaranatagoorunarsuarooq	Once again, they tried to build a giant radio station, but apparently it was only on the drawing board
nalunaarut, oqariartuut	message
nalunngilaa, ilisimavaa	she knows it
naluppoq	to swim
nammattagaq	backpack
namminersorneruneq	home rule (government)
nanivaa	he finds it
nanoq	polar bear
nappaat, ajuut	disease
napparsimasoq	ill
napparsimasunik ikiuisartoq	nurse
napparsimavunga	I'm sick
napparsimmavik	hospital
naqinneq	letter (a, b, c...)
naqqup-ilua	basement
naraseq	frog
narsaq	plain (geography)
nasaq	hat
nassaaraa	find, discover
nassiuppaa	he sends it
nassuiaat, sukuiaat, nalunaajaat	explanation
nassuiarpaa, paasisippaa	to explain it
nataarnaq	halibut
nateq	floor
natersuaq	rug
natseq	ringed seal
natsersuaq	hooded seal
nattoralik	eagle
naviagaa	to consider it dangerous
-neq ajorpoq, -nngisaannarpoq, -juippoq	never (would never, have never, never)
-neq, -iluni	to (infinitive marker)
neqi	meat
nereriarluni uffarpoq	he went in the bath after having eaten
Nerilluarisi!	Bon appetit!
neriniarluni ingippoq	she sat down to eat
neriniartarfik	restaurant
neriorsorpaa	he promises something
nerisassat	food
nerisussuaq	cow
neriugisaq, neriunneq	hope (noun)
neriuppoq, neriugaa	he hopes
neriuut	hope
neriuutigaa	he hopes
nerivoq, -torpoq	to eat
nerleq	swan
nerriveeraq	coffee table
nerrivik	table
nerriviusaq	counter
nersussuaaraq	calf
nersussup neqaa	beef
nersutit	terrestrial mammals
never does X	-uippoq, -suippoq
never has, is never	-nngisaannarpoq
new	-taaq, -taat
New Year	ukiortaaq
-ngajaler	right before (somebody) (verbed)
-ngat, -pat, -runi	when (conjunction)
niaqoq	head
niaqorlunneq	headache
niaqulaarputit	you're crazy
niguavoq, nigorpoq	shy (for humans), always eager to get away
niisa	porpoise
nikagaa	he believes something to be insiginificant
nikassaasoq	victor
nikavoq	is sad, is depressed
nikippaa, allanngorpoq, taarserpaa	to change
nilak, nilakkaaq	fresh water ice piece
nilakulaaq	leopard
nillataartitsivik	refrigerator
nillertoq	it is cold (n)
nillissuseq	cold (noun), temperature (when referring to outdoor cold)
nimissiaq	wire
ningaaq, sakiatsiaq	brother-in-law
ninngaappaa	gets angry with him
ninngappoq	is angry
ninngassarpaa, ninngassaarpaa	irritates him, teases him, provokes him, gets him angry
ninngassarseriippoq	he is patient
niooqqaavoq	to dump something
nipisa	lumpsucker
nipi	sound
nissik	hook, boat hook
nitlaappoq	it is snowing
nittartagaq	website, webpage
niuerneq	business, trade
niuertarfiutilik	businessman
niuiarqavoq	broken leg
niu	leg
niviarsiaq	dwarf fireweed
niviarsiaraq	girl
-nngikkallar	before (someone) (verbed)
-nngikkallar + -li	before (somebody) (verbed), marking a contrast to the present
-nngorpoq	to become
no entry allowed	iseqqusaangilaq
norgimioq	Norwegian person
norskit oqaasii	Norwegian language
not approaching him anymore	orninnaveerpaa
not particularly	-pianngilaq, -rpianngilaq
nuannaraajuk?	do you like it?
nuannarneq, tipaatsunneq, aliikkutaq	joy
Nuanneq naapillutit	Pleased to meet you
nuersaavoq	to knit
nuiakkuarpoq	partly cloudy
nuiaq	cloud
nuiavoq	cloudy
nuka	a brother's little brother, a sister's little sister
nukappiaraq	boy
nukissiorfik	power plant
nukittoq, kimittooq, sakkortooq	it is strong
nuliaqanngilanga	I'm not married (said by a man)
nuliaq	wife
nuliara	my wife
nuliassara	my wife-to-be
nunap aningaasai	currency, national currency
nunap assinga	map
nunaqarfik	settlement
Nunatta Ullua	Greenland's National Day (June 21st)
nutaaq	new (adj.)
nutaarsiassat	news
nutsanut panerterut	hair dier
nutsat	hair
nuuppoq	to move (intrans.)
old house	illutoqaq
old	-toqaq, -toqqat
only	-innaq, -innaat
on the way to the fjord	Kangerluliarpoq
ooqattaarpaa, usserpaa	to try (Dan. at prøve)
ooqattaavik	target, goal
oqaannartoq akivara	right after he said something, I answered him
oqaaseeraq	adverb
oqaaseqatigiit	sentence
oqaasilerisoq	linguist
oqaasilerissutit	grammar
oqaasipalaaq	toad
oqaasipiluuppaa	harangues him
oqaatiginerluppaa	speaks badly about him
oqaatsit allattukkat	word list
Oqaatsit ataasiinnaat naammanngillat	One language is never enough
oqaatsit ilitsoqqussat	mother tongue
oqaloqatigineq	conversation
oqaluffik	church
oqaluppoq	speaks
oqaluttualiortoq	author
oqaluttuarpoq, -paa	he tells (it)
oqaluut	verb
oqarfigaa aneqqunagu	she strongly forbade him to leave
oqarfigaa angerlaqqullugu	she told him he should come home
oqarpoq	says
oqimaalutarfik	scale (n.)
oqqapput, assortuupput, akiuuppoq	quarrel, fight (physical or otherwise)
oqqippoq	abuses
oqquarpoq	warm (weather)
oraansia	orange (color)
ordbogi	dictionary
orluvoq, nakkarpoq	it falls
orniginngikkallarpara	I don't have time for that right now
orpigaq	bush
orpik	tree
orsiivik	gas station
orsoq	blubber, seal oil
paarnaq	black berries, fruit
paarngap issera	juice
paasissutissaq, ilisimatitsissut	information
paasissutissat kingulliit ilanngullugit takussutissiaq	updating / updates
pære	pear
-paluppoq	seemingly, it seems (suffix)
paneriartorpoq	to dry
panertoq, isugutanngitsoq	dry (adj.)
panik	daughter
pappialakoorfik	wastebasket
pappiara	paper
Patsit!	Sorry! (To get by)
pattagiaq noqartilik	piano
pattagiaq	organ (instrument)
pattappoq	he plays the piano
peqarpoq	he has something
peqatigalugu	together
peqqissaasoq	nurse
peqqissuseq	health
peqquaa	to allow (trans.)
pequt	furniture
perorsaasoq	nursery school teacher
perusuersartarfik	toilet
piaarpoq	is early
piareersarpoq	to prepare
piffissaq	time
pigisaq	thing
piiaaffik	mine (industry)
piiaat	eraser
piiarpaa	he mines it
piiarpaa	to strip, to remove
pilerinarpoq	is attractive / desirable
pilersaarpoq	he intends to, he plans to, he thinks of doing
pilersaarusiaq	plan (alt.)
pilersaarusiorpaa	she plans it
pilersaarut	plan
pillaat	punishment
pilluarneq	happiness
pilluarpunga!	lucky me!
pillugu	concerning, about
pingaarneq	the status of being the most important
pingaarpoq	it is important
pingaartoq	important
piniarpoq, aallaaniarpoq	to hunt
piniartoq, aallaaniaq	hunter
pinngortitaq	nature
pinnguaat	game
pinnguaq	toy
pinnguarpoq	to play (with toys, etc.)
pinnguartarfik	playground
pisaraa, tiguaa	to catch
pisarialik	necessary
pisariaqarpoq, -tariaqarpoq	must
pisarnertut, -sarpoq, -tarpoq	usually
pisarpoq (intrans.)	accumulates a supply of something
pisarpoq (reflexive)	commits suicide
pisassaq, ilinniagassat	homework
pisiniarfik, niuertarfik	shop (place)
pisiniarfissuaq	supermarket
pisiniariarpoq	she is going shopping
pisiniarpoq	to shop
pisiniartitsisoq	shop assistant
pisinnaaguni aggerniarpoq	he's coming, if he can
Pisortatigut oqaatsit	Official language
pissanganaq!	exciting!
pissangavoq	it is exciting
pissanngatigaa	is excited
pissaq	strong (person)
pissiartaarpoq	is engaged
pissippoq	to jump
pissuseq, oqaatsip naaneqarnera	form
pissusilerissut	adjective
pisuinnartunut aqqutissiaq	path
pisuppoq	to walk
pisusilerissut	bottom (adjective)
pisuttuarpoq	to go for a walk
pisuttuarumalluni anivoq	he went out to go for a walk
pisuujuvoq	is rich
pitsaassuseq	quality (as opposed to quantity)
piumasarisaq	entitlement, demand
pivaa, -lerpoq, -tippoq, -ssaaq	to get
pivoq	it happens
Place/time where something happens, appointment to...	-fik, -fiit, -vik, viit
place with seals	puisilik
politeeqarfik	police station
politeeq	police officer
poorski	easter
portusooq	high
prærieului	coyote
provided, equipped with	-lik, llit
provided him/her with X	-lerpaa
provided him with boots	kamilerpaa
pueqqorpoq	it is cool (weather)
puiaasaq	bottle
puiguivoq	he forgets something
puiorpaa	he forgets it
puisi	seal (animal)
pujoqariarmat qatsorumaataarami	there was fog, and it was a long time until the wind subsided
pujoq	fog
pujorpoq	it is foggy
pujortarpoq	smokes
pukkitsoq, atsissoq	low
pulaar-	to visit
pulateriaarsuk	snake
punneq	butter
pupik	mushroom
put forth X, made X	-liorpoq, -iorpoq
puttaaq, sikutaq	ice floe
puugutaq	plate
puugutarsuaq	dish
puulukip neqaa	pork
Qaaguk!	Gimme that!
Qaa iluamik!	Pull yourself together!
qaamasoq, oqitsoq	light (adjective)
qaammatip tullia	next month
qaammat kingulleq	last month
qaammat	moon, month
qaanga, qaqugu	when (adverb, question)
qaangiuppoq	it is over
Qaa ninngaateqisa!	Come on, let's fight!
qaani	on top of
qaaqquaa	to call on someone, to invite someone
qaaqqusaavoq	he gets invited
qaaqqusissut	invitation
qaaq	surface
qaartitsivoq	blast (v.)
qaarusummi sulisartoq	miner
qakkorsii	you guys in there
qaleralik	Greenland halibut
qalerualik	shellfish
qaliani	upstairs
qaliaq	roof
qalipaasoq	painter
qalipaat	color (noun)
qalipagaq	painting
qalipappaa	he colors it
qallersuutissat	cold cuts
qamani	over there
qamippaa	to turn off
qamuteralaat, snescooteri	snowmobile
qaneq	mouth
Qangali takugakkit	Long time no see
qanoq akulikitigisumik?	how often?
qanoq-issuseq	situation
qanoq ittumik	what kind of...
qanoq sivisutigisumik?	how long?
qaqorsaat	soap
qaqorteqqasussat	rice
Qaqqap qaani kumak qarrakoq	Squashed flea on top of a mountain
qaqutiguinnaq, qaqutigut, qaqutikkut	rarely
qaqutigut	occasionally
qarasaasiaq, computeri	computer
qarliit	trousers, pants
qarlippaat	outdoor trousers
qarlortaat	flute
qasersoq	grey
qasigiaq	harbor seal
qasilitsoq	green pepper
qasilitsut	pepper
qasseersiut	plural (adj.)
qassinut...?	what time...?
qassiterpaa	to loosen
qassit?	how many?
qasuvit?	are you tired?
qatangut angut	brother (formal)
qatanngut arnaq	sister
qatanngut	sibling
qatigattooq	camel
qatserisarfik	fire station
qatserisartoq	fireman
qeeraq	catfish
qeqarpoq, nikorfavoq	to stand
qeqertaq	island
qeqqani	in the middle
qerititsivik	freezer
qiavoq	to cry
qiilasooq	antelope
qilaaq	ceiling
qilak	heaven, the sky
qilalugaq qaqortaq	beluga
qilalugaq qenertaq	narwhal
qilamik	soon
qilanaaraa	he's happy about it
qillerpaa	to drill
qilusoorneq	cramp
qimaguppoq, anivoq, -mukarpoq, -liarpoq	to go
qimappaa	to leave, to abandon
qimmeq	dog
qimuppoq, uniarpaa	to pull
qimusseq	dog sled
qimusserpoq	to ride
qingalissuaq	turkey
qingaq	nose
qinngoq, nataaq, nateq	bottom, base (noun)
qinnuigineqarpusi uunga peqataanissassinnik nalunaaqqullusi	You are requested to sign yourselves up here
qiorpaa, pilappaa, kilerpoq	to cut
qipivaa	to screw
qipoqqaq	humpback whale
qisuk	wood (material)
qisummit illuliaq	a wooden house
qiterleq, qeqqaa	middle (n.)
qitippoq	to dance
qitsuk	cat
qiuutit	scissors
qoorlutooq	duck
qorlortoq	waterfall
qorsuk	green
-qqaarsinnar	after first having (verbed), contemporaneous marker
-qqajanngit-	long before (something) (verbs) (use only for participles)
-qqu	after a command verb, the verb in which this is used indicates a second agent
quersorneq	cough (noun)
quersuaq	warehouse
quiasaarneq, ikasarneq	fun (noun)
qulaani	above
qulaani, sinnerlugu	over (preposition)
qularnaatsoq	sure (adjective)
qularnanngilaq	no doubt about it
qulippoq	wash hair
qulleq	lamp
qulleq	top (location, preposition)
qulliup napasua	lamp post
qummut	up
qungaseq	neck
qungasequt	scarf
qungasersooq	giraffe
qunguleq	cabbage
qupaloraarsuk	snow bunting
qussuk	swan
quttoraq	thigh
raaja	prawn
rådhusi	town hall
radio, tusartaat	radio
real, correct	-vik, -viit
real name	ativik
receptionisti, saaffiginnittarfimmiu	receptionist
removed dirt from him	ipeerpaa
removed X from him/her	-erpaa, -uerpaa
resident	-miu, -miut
resident of Nuuk	Nuummiu
-riallar-	then (something) (verbed), something surprising happened
-riar-	as soon as (subject) (verb), after having (verbed)
russeq	Russian person
russisut	Russian (adj.)
Russit Nunaat, Ruslandi	Russia
ruujorilerisoq	plumber
saagoq	curtain
saamerleq	left (direction)
saamiatungaani	to the left of
saaniluk	turtle
saarullik	cod
saattuaq	snow crab
sakappaa, ajappaa	he pushes it
saki	father-in-law
Sakkutuut Sallutuut Sakkortuut	Strong lying soldiers
salaati	salad
salaatit	lettuce
salloqaatit!	liar!
salluvoq	he lies
sallu!	you lie!
sammisaq taanna oqallisigisimanngilarput	we have not discussed this topic
sammisaq	theme, topic
sammivik	direction
sanaartornermi sulisartoq	construction worker
sanasoq	carpenter
sanavaa, -liorpoq	to make something
saneraq	side
sangutippaa, kaajallaappoq, ipippaa	to turn
saniani	beside, next to
saniatigut, aammattaaq	furthermore
sanigorpoq	to lose weight
sanimukartoq	horizontal
sapaatip-akunnera	week
sapernarpoq	is insurmountable, is very difficult to do
sapiipputit	you are brave
sapivaa, sapisivoq	blocks it (road / river)
saqisoq, stewardesse	stewardess
saqisoq	waiter
saqqummerpoq	it comes out (as in the book is coming out soon)
savaasaq	goat
savaatilik	sheep farmer
savaussaq	ram
savik	knife
savik unngiaat	razor
Schweizi	Switzerland
seeks, celebrates	-siorpoq
seeqqoq	knee
seqinnerpoq	it is sunny
sequmippoq	it is destroyed, eradicated, broken, obliterated, pulverized
sequtserpaa	he grinds it
sermeq, sermeq iigartartoq	glacier
sermersuaq	ice cap
she is his daughter	panigaa
siallerpoq	it is raining
sialuk	rain
sianiippoq	it is stupid
Sianiissuaq!	Idiot! (Slang)
siataq	roast (n.)
siataq	steak
siatsivik	pan (n.)
sikaavik	cupboard
sikkersoq	blossom (n.)
sikkilerpoq	to bicycle, to ride a bike
sikkili	bicycle
siku, sermeq	ice
sikut katinngasut, sikorsuit	pack ice
silaannarissarpaa	to ventilate
silagippoq	the weather is good
silaqqippoq	the weather is great
silarluppoq	the weather is bad
silatuvoq	he is clever
sineqqaarsinnarluni	after first having slept
sineriak	coast
sinerlugu	along (preposition)
siniffik torersarpaa	make the bed
sini	frame
sinippoq	to sleep
sinittarfik	bedroom
sinnaavoq	he can
-sinnar	after first having ~ (verb)
sinnattoq, takorluugaq, sinnattugaq	a dream
sinnattorpoq	to dream
siornani	in front of
siornatigut, -tinnani, -tinnagu	before
sipeerpoq, atorpaa	to spend
sisamanik, saneralik	square (adj.)
sisamanngorneq	Thursday
sisoraatit	skis (n.)
sisorarpoq	to go skiing
sissaq	beach
sissinnguaq	squirrel
sissuerpoq	is aware, is taking note
sisuaq	stone (n.)
siulittuut	prediction
siulleqqiutit	preposition
siullermik	first
siullunneq	earache
siunnersuivoq, siunnersuutigaa	to suggest
siut	ear
siutitooq	donkey
siutitooq nimeruaartoq	zebra
sivisussuseqarpoq	to take (s)
skåli	bowl
skuut	shoe
small, cute, positive	-nnguaq, -nnguit
sold	-erniarpoq, -uerniarpoq
sold seal	puiseerniarpoq
something like a...	-usaq, -usat
soorlu, -tut, -sut, -tillugu, -tilluni, -ruttortoq	as, like
soqutiginarpoq	it is interesting
soqutigisaqaqatigiit	Interest Group (hobbies, etc.)
soraaginnarluni atorfittarpoq	right after he quit, he got a new job
soraarpoq	he quits, he stops it
soraarpoq	to get off
sorleq	which (s.)
sorliit	which (pl.)
so, so that, thus he does...	-qqunagu
so, so that, thus he...	-qqullugu
so that he sleeps	sineqqullugu
so that it doesn't break	aseroqqunagu
Spaniamioq	Spanish person
Spaniamiutut	Spanish Language
Spania	Spain
spoke to him/her	oqarfigaa
-ssasimavoq	maybe (suffix)
stereomik tusarnaarut	stereo
sukaterpaa	tighten
sukkut	sugar
suliartorpoq	to go to work
suliassat, suliassaq, niuerneq	business
suliffimmi naalagaasaq	foreman
suliffissarsiaq	job, position
suliffissarsivoq	he got a job
suliffissuarmi sulisartoq	factory worker
sulillatsiaannarluni aneqqippoq	after only having worked for a short time he went again
suli namik	not yet
sulinngikkallarmat	before he started working
sulisoq	worker
sulorarneq, badmintoni	badminton
suluk	wing (animal)
suluppaagaq	redfish
sumiiffik	place
sumiluunniit	everywhere
sungaartoq aappaluaartoq	orange
sungaartoq	yellow
sungiusarneq, sungiusaat	exercise, practice
sungiusarpoq	to exercise, to practice
sununnarpit?	where are you going?
suppa	soup
supputaasaq	accordeon
susaq	thing, object
susoq	subject, topic
svejserivoq	to weld
svenskeq	Swede
taaguutit	terminology
taakku pigat, -at, -rtik, -tsik, -tik	their
taakku	those ones
taakua, ukua	theirs
taamaaliorpoq akeqqulluni	he did that so he (himself) could get an answer
taamaaliorpoq sineqqullugu	he did that so she could sleep
taamaallaat, -innaq	"just (as in ""just a little bit"")"
taamaallaat	only
taamaannirpoq	I wonder if this is so
taamaan-	to be thus
taamak (adv.)	thus
taamak!	That's enough! Stop it!
taarpoq	it is dark
taarserpaa, taarsiivoq	to replace, to swap, to pay back, to return something rented
taasivoq	to vote, to cast a vote
taassuma	his, hers
taavaa	to call him / her something
taava	so, then
taggisip taartaa	pronoun
taggisit taartissaat	pronoun (full form)
taggit	name applied to something, term
taggit	noun
takes, brings (for oneself)	-torpoq, -storpoq
takisooq	tall
takornariaqarneq	tourism
takornariaq	tourist
takuaa	he/she sees her
takuaanga	he/she sees me
takuaannga	they see me
takuaasi	he/she sees you (pl.)
takuaasi	they see you (pl.)
takuaatigut	he/she sees us
takuaatigut	they see us
takuaatit	he/she sees thee
takuaatsit	they see thee
takuaat	they see her
takuaat	they see them
takuai	he/she sees them
takuarma	you see me
takuarput	we see her
takuarsi	you all see him
takuasi	you all see them
takuassinga	you all see me
takuassi	we see you (pl.)
takuatit	you see them
takuatsigit	we see thee
takuatsigut	you all see us
takuatsigut	you see us
takuat	you see her
takuavut	we see them
takulaaruk!	look!
takunnippoq, takuaa, paasivaa	to see
takuqqikkunaarpugut!	we'll see each other again! bye!
takussutissaq, maligassaq	example
takuuk, -paluppoq, isikkoqarpoq	to look
talerperleq	it is on the right
talerpiatungaani	to the right of
talittarfik	quay
tallimanngorneq	Friday
tamaara	all of them
~ tamaasa	every ~
tamalaanik qalipaatilik	with many colors
tamalaat	all sorts (of)
tamanut ammaneq	public (out in the open)
tamarmik	all of them (nominative)
tamassa iseritsi!	please come in!
tamatigut, innarpoq, juarpoq, juaannarpoq, tuaannarpoq	always
~ taminneq	the next ~
tarajuaqqat, taratsut	salt
-tariaqarpoq, -ssagaluarpoq	to should (suffix)
tarrarsuut	mirror
taseq	lake
Taskeqakataqaanga	I'm tired of holding this backpack
taskini tigusinnarlugu anivoq	she took her bag and went out
tassanngaannaq	suddenly
telefoni, oqarasuaat	telephone
telefonip normua	phone number
teqeqqoq	corner
terianniaq	Arctic Fox
terianniaq	fox
teriaq	mouse
the weather is good	silagippoq
tiguaa	she takes it
tigumiarpaa, nammappaa, ersuppaa	to carry
tigumiarpaa	to hold
tii	tea
tiitorfik	cup
tiitorfiup allia	saucer
tiitorpoq	to drink tea
tikaagullik	minke whale
tikaagulliusaaq	fin whale
tikeqqajanngitsunga aallarpoq	he went long before I came
tikeriarama majuarpunga	as soon as I arrived, I went up
tikeriarllartoq ilani aallareersimasut	when he came his friends surprisingly had left already
tikeriaruma majuassaanga	as soon as I come, I go up
tikikkassi	are you already there?
tikinngila?	didn't he come?
tikippa?	did he come?
tikippunga	I've arrived
~ tillifigitippunga	my ~ got stolen
tillinniiaq	thief
-tillugu, -sillugu	during
-tillugu, tilluni, -ruttortoq, massa	while
tilluusaq	bruise (noun)
time/place of arrival	tikiffik
timersorneq	sport, sports
timersortarfik	sports hall
timmiaq	bird
timmisartoq	airplane
timmisartortartoq	pilot
timmivoq, timmisartorpoq	to fly
tiny house	illuaraq
tipappoq	is flippant
titartaavoq	to draw
titartakkat	animated cartoons
to a room to be indicated	inissaq
"to become ~ (participle, like ""sated"", ""hurt"")"	-neqarpoq
to cause him to...	-tippa, -stippa, -titsivoq
to have X as one's own	-gaa, -raa
tomati	tomato
toqqarpaa	to appoint someone or something, to select for an honor or prize out of a bunch
toqqusaarlunneq	sore throat
torersaavoq	to clean
torsuusaq, gangi	hall
travels to X	-liarpoq
-(t)sii(sige)	until ~ (verb)
-ttaaq, aammattaaq	also, as well
tui	shoulder
tujuuluaraq	blouse
tujuuluk	shirt
tullianik	next time
tulugaq	raven
tuluit oqaasii	the English Language
tuluk	Englander, Englishman
tumerparpaaq	drum (n.)
tungujorteq	blue
tungujortoq qaamasoq	light blue
tunguusaq	purple (adj.)
tunisivoq, tunivaa	to give
tunivaa, akigaa	she sells it
tunniutinngilaa, -tuarpoq	to keep
tunuani	behind
tupaarnaq	thyme
tuqu-	to die
tusarnaarpoq, tusarnaarpaa	she listens, she listens to
tusarnaartitsineq	concert
tusarpoq, tusaavaa	to hear
tuttorguaq	deer
tuttorpak	moose
uagununa, uagunuku	ours
uagut, -rput, -vut	our
uagut sorsunnerinngilarput	it is not our fight
ualeq	afternoon
uangaana, uangaakku	mine (sing. / pl. [possessive])
uanga manna qimalerpara!	I'm getting out of here!
uanga piga, -ga, -ra, -kka	my
uani	here
uanitsoq	onion
uatsinni	by us, at our place
uatsi!	wait a bit!
uffaat	bath, water in which one washes
uffarfik	bathroom, washroom, bathtub
uffarpoq	to take a bath
ugsik	bull
ui	husband
uiloq	bivalve
uiloq	mussel (or any other type of bivalve)
uini isersiillugu igarusaarpoq	she was having fun cooking until her husband came home
uinippoq	she marries
uini toqunngikkallarmalli qiimaatsuuvoq	she was also sad about it before her husband died
uippoq	opens his eyes, looks up, begins to see
uissara	my husband-to-be
ujarak	rock
ujarpaa, qinerpaa	to look for
ukaleq	hare
ukiaq	autumn
ukiup ilaa	season
ukiut hundredikkuutaat	century
ukiut qulikkuutaat	decade
ukiut tusintilikkuutaat	millennium
ukuaq, sakiatsiaq	sister-in-law
uku	they
uku, ukua, makku, makkua, taakku, tamakku, tamakkua	these
ulik	blanket, cover
ulikkaartoq, naammatsittoq	it is full
ullaakkorsiorpoq	to eat breakfast
ullaaq	morning
ulloqeqqasiorpoq	to eat lunch
Ulloq naalluarniariuk!	Have a nice day!
ulloriaq	star (n.)
ullororpoq	it is daytime
ulloruleraluartillugu	in the middle of the day
ullumi	today
umiarsualivik	harbor
umiarsuaq	ship
umiarsuup naalagaa	captain (lit. ship boss)
umiartorpoq, pujortuleerarpoq, timmeralaarpoq	to sail
umiatsiaq	boat
umiatsiaq sukkasuuliaq	speed boat
umimmak	musk ox (alt.)
umummak	musk ox
unemployed	suleqanngitsoq
ungasissoq	far
uniaaluk	ant
unippoq	stop
unittippaa!	stop him!
unngiarnermi qapuk	shaving cream
unnuk	evening
unnukkorsiorpoq	to eat dinner
upernaaq	spring
upperpoq	to believe
upperuseq	religion, cult, rule by religion or cult
userarpoq	to spill
usilersorpaa, immerpaa	to load
ussassaarut	advertising, ad, lure, bait
ussuk	bearded seal
utaqqivoq	to wait
uteqattaarpoq	paces, walks back and forth
Uteqqissinnaaviuk?	Could you repeat that?
uterpaa	to repeat it
-utige, -itige (before i or schwa) -jutige (after a long vowel)	contemporaneous marker
utiraaruk	repeat that, please
utoqqaassuseq	age
utoqqaq, nutaanngitsoq	old
uuararsimasoq	sunburn
uumaa!	listen up!
Uuma Angutip tamaasa akilissavai	This gentleman will pay for everything
uumap piga	his, hers (two words)
uumasoq	animal
uumasoq imarmioq	marine mammal
uumasuusivissuaq	zoo
uuppaa	to cook
uuterisoq	baker
varevogni	van
videomi pinnguaat	video game
viinisorfik	wine glass
viini	wine
wants that he/she...	-qquaa, -qqusivoq
we never spoke	oqanngisaannarpoq
whaleskin piece	mattamineq
while he eats	nerisillugu
without X	-qanngitsoq, -qanngitsut
work colleague	suleqat
worked together with him	suleqatigaa
young animal, mini-	-araq, -aqqat, -uaraq, -uaqqat
