_기 연습해요	practice _'ing
_라고 말하다	to say that_
_라고 해요	it's called_
_를 한국어로 뭐라고 해요?	How do you say _ in Korean?
_씨 좀 바꿔 주세요	please transfer me to _
_필요해요	need_
가 보다	try to go
가게	store
가격	price
가구	furniture
가구점	furniture store
가까워요	[present]: to be close (distance)
가깝다	to be close
가끔	sometimes
가는 말이 고와야 오는 말도 곱다	words going out must be beautiful for words coming in to be the same
가다	to go
가득하다	to be full, crammed
가라앉다	to sink
가랑비에 옷 젖는 줄 모른다	small things can accumulate
가르치다	to teach
가리키다	to point, to indicate
가방	bag
가방을 들다	to carry on a bag
가방이 의자 위에 있어요	the bag is on top of the chair
가볍다	to be light
가사	lyrics
가수	singer
가슴	chest
가시죠	[polite] Let's go
가십시오	[formal imperative]: to go
가운데	center, the middle
가을	fall
가장	most
가져가다	to take
가족	family
가지 마라	don't go (plain)
가지 못해요	[polite]: (I) cannot go
가지 않습니다	[formal]: (I) do not go
가지다	to have
갈비	ribs
갈아타다	to transfer
감기에 걸리다	to catch a cold
감동적이다	to be (emotionally) touching
감상하다	to appreciate (art)
감자	potato
감정	feelings
감추다	to hide, to disguise
갑자기	suddenly
값	Price
강	river
강하다	to be strong
갖다	to bring
같이	together
같이 운동하기로 했다	[plain]: (We) decided to work out together
개	dog
개론	an introduction to
개미	ant
거기	there, that place
거기가 제일 싼 곳이에요	that is the cheapest place
거든요	you see (because)
거리	streets
거미	spider
거스름돈	change (money)
거실	living room
거의	almost
거의 다 왔어요	we're almost there
거짓말하다	to Lie
걱정이다	to be a worry
건강	health
건강을 위해서	for health, for the sake of health
건너다	to cross
건물	building (g)
건조하다	to be dry
건축가	architect
걷다	to walk
걷어요	[present]: to tuck, collect
걸리다	to take (time)
걸어가다	to go on foot
걸어요	walk
검정색	[adj]: black (color)
것 같다	it seems like
게 되다	turn out that
게을러지다	to become lazy
게임	game
겨드랑이	armpit
겨울	winter
견과	nuts
결과	result
결정하다	to decide
결혼하다	to marry
경기	game (sports)
경우	case
경제학	economics
경찰	policeman
경치가 좋다	scenery is good
경험	experience (經驗)
계단	stairs
계란	egg
계산서	a bill; a check; "calculation paper"
계세요	[formal present]: to be (to exist)
계속되다	to continue
계시다	to be (있다 honorific)
계절	season
계절마다	every season
계좌	account
계획	plan
고개를 숙이다	to lower one's head
고궁	An ancient palace
고등학생	high school student
고르다	to choose
고마워	[informal]: thank you
고모	father's sister
고민	worry
고백하다	to confess
고생하다	to have hardship
고속도로	highway, freeway
고양이	cat
고요함	serenity
고장나다	to be broken
고추	pepper
고층빌딩	high-rise building
고치다	to fix
고향	hometown
곧	right away, soon
골동품	antique
골프	golf
곳	place
공	[native]: zero
공기가 맑다	Clean and Fresh air
공무원	government worker
공부 열심히 하자	let's study hard
공부를 잘해요	study well
공부하고 싶어요	I want to study
공부하다	to study
공부하라고 했어요	(someone) told (me) to study
공부하러 도서관에 가요	I go to the library to study
공부해야겠어	[intimate]: (I think) you should study
공사	construction
공연	performance
공연을 보다	to watch a performance
공예품	handicraft item
공원	park
공책	notebook
공항	airport
과목	subject
과식하다	to overeat
과외 아르바이트	tutoring
과일	fruit
과자	Snack
과학	science
관광객	tourist
관악산	gwanak mount
괜찮아요	it's okay
굉장히	very, alot
교과서	textbook
교복	school uniform
교수님	professor
교실	classroom
교통	transportation （交通）
교통 표지판	traffic sign
교통수단	means of transportation
교통이 불편하다	transport is inconvenient
교통이 편리하다	transportation is convenient
교통카드	transportation card
교환 학생	exchange student
교회	church
구	[sino]: nine
구경하다	to look around
구두	shoes
구름	cloud
구름이 끼다	to get cloudy
구하다	to search for
국경일	national holiday
국내선	domestic flight
국수	noodle
국제	international
국제선	international flight
굽	heel
궁금하다	to be curious
권	for counting books
권유	Suggestion
귀	ears
귀걸이	earrings
귀엽다	cute
귤	tangerine/mandarin orange
그	he
그 책을 사기 전에는 도서관에서 빌려봤어	[intimate]: before I bought the book, I borrowed it from the library
그건	that thing (topic)
그걸	that thing (object)
그게	that thing (subject)
그게 다야	that's all
그냥	just, without any special reason
그네	swing
그녀	she
그동안 어떻게 지냈어요?	how have you been (while i haven't seen you)?
그래	okay/yes
그래도	but still
그래서	so, therefore
그래서?	so what?
그래요?	Really?
그러면	then
그런데	[informal]: but, however
그럴게요	[volunteer]: I'll do that
그럼요	of course
그렇구나	I see what you mean
그렇지 않아도	even without your saying so
그렇지만	[4]: however
그릇	bowl
그리고 나서	and after that
그리다	to draw
그림	picture
그립다	to miss, long for
그만	stop, cease
그외에	etc
그저 그렇다	to be so-so
그쪽	that way
극장	movie theatre
근처	nearby, vicinity
글	words, a verse
글쎄요	hmm.. it's hard to say
금강산도 식후경이다	Even Mt. Kumkang looks better after eating
금년	[sino]: this year
금방	soon
금색	[adj]: gold (color)
금요일	Friday
급하다	to be urgent
기가 쉽다	it is easy to ...
기가 어렵다	it is difficult to...
기다려 주세요	[formal]: please wait
기다려지다	to be wished
기다리다	to wait
기로 하다	[grammar]: decided to
기름	oil
기름지다	to be fatty, greasy, oily
기분	mood
기분 전환을 하다	to change your mood (for the better)
기분이 나빠요	feelings bad
기분이 좋아요	feelings good
기쁘다	to be joyful
기사	article/knight
기숙사	dormitory
기억하다	to remember
기온	temperature
기자	journalist
기장	captain, pilot
기차	train
기침을 하다	to cough
기타	guitar
기회	opportunity
긴장하다	To be nervous
길	road/street
길다	to be long
길이가 얼마예요?	How long is (its) length?
김 선생님이 버클리에 온 지 얼마나 됐어요?	How long has it been since 김 선생님 came to Berkeley?
김밥	
김치 찌개나 된장 찌개를 드세요	[honorific]: Please have either kimchi stew or soybean paste stew
김치찌개	kimchi stew
까맣다	to be black
까먹다	[colloquial]: to forget
까지	up to (location)
깎다	to cut (price); to discount; to bargain
깜짝 파티	surprise party
깨끗하다	to be clean
깨우다	To wake (someone) up or awaken
깨지다	to break
꺼요	[present, polite]: to turn off
껌	gum
께서	subject particle (honorific)
께서는	topic marker (honorific)
꼭	for sure
꿈꾸다	to dream
꿈을 이루다	To achieve one's dreams
끄다	to turn off
끓이다	to (be) boil(ing)
끝나다	to be over, to be finished
끝내다	to finish
끼다	to wear (hands)
ㄴ다	plain style: used after an action verb stem ending in a vowel
나 낚였어	You got me/had me going
나가다	to go out
나누다	To divide
나는 버클리 학생이다	[plain]: I am a student at Berkeley
나는 선생님이 되고 싶어요	I want to be a teacher
나는 영어밖에 못 한다	[plain, intimate]: I can only speak english
나는 일기를 하루밖에 못 썼다	[plain, intimate]: I was only able to write in my diary for one day
나는 피아노 연습을 한 시간밖에 안 한다	[plain, intimate]: I practice piano for only an hour
나다	To occur; to break out
나라	country
나무	tree
나쁘다	to be bad
나오다	to come out
나의 것	mine (my thing)
나이	age
나이가 들다	to get old (to increase in age)
나중	later
나중에	later
나중에 다시 하겠습니다	(I) will call you again later
나타내다	to show, represent
나흘	four days
낚시를 하다	to fish
난 지금 일 불밖에 없다	[plain, intimate]: I have only one dollar now
난방	heating
날씨	weather
날씨가 좋았다	[plain]: the weather was good
날씬하다	to be slim
날짜	a date
남다	to remain
남아 있다	to remain in a place
남의 떡이 더 커 보인다	Someone else's rice cake always looks bigger
남자	male
남자친구한테 차였어요	I was dumped by my boyfriend
남쪽	south
낫다	to recover
낮	daytime
낮다	to be low
낮아지다	to get lower
낮잠을 자다	to take a nap
내 진짜 친구는 너밖에 없다	[plain, intimate]: you're my only real friend
내가 먼저 도착했어	I arrived first
내꺼	Its mine
내년	[sino]: next year
내다	to pay (money)
내려가다	to go down
내리다	To get off
내용	contents (内容）
내일	tomorrow
내일 바쁠 것 같아요	[polite]: It seems that I'll be busy tomorrow
내일 비가 온다고 했어요	(someone) said it's going to rain tomorrow
내일은 비가 오겠습니다	[formal]: It will probably rain tomorrow.
내일은 일찍 일어나야 돼요	I need to wake up early tomorrow
냉면	cold noodles
냉장고	refrigerator
너라도 돼	[intimate]: It is okay that it's you
너라야 돼요	it has to be you
너무 많이 마셨어요	I drank too much
너무 많이 먹어요	I eat too much
너의 것	yours (your thing)
넓다	to be wide
넘어지다	to fall (down)
넘어지지 마세요	don't fall
넣다	to put in
네요	Suprised exclamation ending
넥타이를 매다	to wear a tie
넷	[native]: four
노란색	[adj]: yellow (color)
노래	song
녹다	to melt
놀라다	to be surprised
농구	basketball
농사	farming
높다	to be high
높아지다	to become high
높은 건물이 많다	to have many tall buildings
놓다	to put
놓치다	to miss
누구	who
누구하고 갈래요?	With whom would you like to go?
누군가	somebody
누나	[male point of view]: older sister
누르다	to press
눈	snow
눈사람	snowman
눈썹	eyebrows
눕다	to lie down
뉴욕	New York
느껴지다	to feel
는 길이다	(be) on one's way
는 데에	in/for ~ing
는 지 되다	it has been ___ since ...
는 편이다	to tend to
는다	plain style: used after an action verb ending in a consonant
는지 알다 모르다	to know/not know where
늘다	to increase
늙다	To get older (in quality)
늦다	to be late
늦잠	oversleeping
니꺼	[informal]: yours
다	plain style: used after a descriptive verb stem
다 먹고 싶어요	I want to eat all
다가	movement from one action state to another
다녀오다	to go and get back
다니다	to attend/commute
다락방	attic
다른	different (other)
다리	legs
다리를 꼬다	to cross one's legs
다섯	[native]: five
다시	again
다시 말해주세요	please say it again
다양하다	To be various, diverse
다음	next
다음 주	next week
다음 주에는 따뜻하겠습니다	[formal]: It will probably be warm next week.
다이어트하다	to go on a diet
다치다	To get hurt
닦다	To wipe
단락	paragraph
단순하다	To be simple
단어	word
단정하다	To be neat
단풍	fall foliage
닫다	to close
닫히다	to be closed
달	moon
달다	to be sweet
달라요	[present polite]: to be different
달력	calendar
달리다	to run
달콤하다	to be bittersweet
닮다	to resemble (for people)
담배를 피워요	smoke a cigarette
담요	blanket
답	answer
당근	carrot
당연하지	You bet
대기실	waiting room
대답하세요	please answer me
대상	object, target
대신	Instead of
대중	the public
대충	roughly
대통령	president
대학교라서 학생이 많아요	There are many students as it's a university
대화	conversation
댁	[honorific]: house
더 먹고 싶어요	I want to eat more
더 열심히 공부하기로 했다	[plain]: (I) decided to study harder
더 자연스러운 표현은 뭐에요?	what's a more natural expression?
더럽다	to be dirty
더워요	it's hot
던	used to be (non-modifying)
덜	less
덥다	to be hot
데리고 가다	to take along (person or animal)
데이빗에게 선물을 줘요	(I) give a present to David
도대체	what in the world; on earth; the hell
도둑	thief
도로	road
도시	city
도시락	lunchbox
도와 드리다	[honorific]: to help
도와요	helps
도움	help
도착하다	to arrive
독서	reading
돈	money
돈은 많은데 시간이 없습니다	(I) have lots of money, but no time.
돈을 많이 벌다	to make lots of money
돈을 찾다	to withdraw money
돌아가다	to return
돌아가시다	[honorific]: to die
돕다	to help
동네	neighborhood
동물	animal
동물원	zoo
동부	East Coast
동생	younger sibling
동생에게 책을 읽어 줬어요	(I) read the book to my younger brother
동아리	club
동안	During
동영상	video clip
동쪽	east
돼지	pig
되다	to become
되다	to function, to work
된장	soybean paste
된장찌개	soybean soup
두 시간 잔 것 같습니다	[formal]: It seems that I slept for two hours
두꺼운 옷	thick clothes
둘	[native]: two
뒤	behind
뒤집다	to flip
뒷마당	backyard
드디어	finally
드라마 촬영지	drama film location
드리다	[honorific]: to give
드세요	[formal present]: to eat
드시다	[honorific]: to eat
듣다	to listen
들다	to carry
들다	to cost
들르다	to stop by
들어 있다	to contain
들어가다	to enter
들어가세요	Bye
들어오다	to come in
들으십시오	[formal imperative]: to listen
등	[body part]: back
등	and so on
등기	registered mail
등록하다	to register
등산객	mountain climber
등산하다	to hike
따뜻하다	to be warm
따뜻해지다	to get warm
따라 하세요	please repeat after me
딱딱하다	to be hard, stiff
딱히	indifference; apathetic
딸	daughter
딸기	strawberry
땀을 흘리다	to sweat
때	period, during, when, time
때리다	to hit
때문	Because of (noun)
떠나다	to leave
떠들다	to make noise [3]
떠들면 안 돼요	you should not make noise
떨어지다	to fall (things)
또	again (又）
똑같다	to be identical
똑똑해요	(you're) smart
똑바로	straight ahead
똥	crap
뚜렷하다	to be clear; to be obvious; to be distinct
뚱뚱해요	(you're) fat
뛰다	to Run
뜨개질하다	to do knitting
뜨겁다	hot to touch
라디오	radio
라면	
래몬	lemon
런던	London
려고 하다	to plan to
룸메이트	roommate
마다	every
마르다	to be skinny
마리	for counting animals
마시다	to drink
마을 버스	town shuttle bus
마음	Heart
마음에 들다	to be to one's liking
마저 드세요	finish the rest please
마중	Meeting, reception
마지막	last
마치다	to Finish
마침	just, just in time
마침 잘 됐네요	It turned out well (just in time).
마흔	forty
막히다	To be blocked
만	10000
만나다	to meet
만들다	to make
만약	If
만지다	to touch
만화방	comic book rental store
많이	many
말 한 마디로 천 냥 빚 갚는다	Saying something nice is as good as paying back a 1000nyang debt
말고	not A but B
말라요	[present]: thirsty, gaunt, skinny, dry
말씀	[honorific]: speech
말씀하시다	[honorific]: to say
말하다	to say
맑아요	[weather]: it's clear
맛	taste
맛보다	to taste
맛이 없어 보여요	looks not tasty
맛있는 것을 먹다	to eat something delicious
맛있는 음식을 먹었어요	(I) ate delicious food.
맞다	correct/oh yeahhh
맞다	to fit
맞아요	you're right
매일	every day
매표소	ticket office
맥주	beer
맵다	to be spicy
머리	head
머리가 길다	to have long hair
머리가 짧다	to have short hair
머리카락	hair
먹거리	things to eat
먹다	to eat
먹어라	to eat (imperative, plain)
먹자	let's eat (plain)
먹지 마세요	don't eat
먹지 못했습니다	[formal]: (I) could not eat
먼저	[time]: first
멀다	to be far
멋있다	to be cool
멍청하다	to be stupid, foolish
메뉴	menu
며칠	what date
면세점	duty free shop
명	for counting people
명절	traditional holiday
명함	business card
몇	how many
몇시예요?	what time is it?
모두	all
모두들	everyone
모레	the day after tomorrow
모르다	to not know
모습	appearance
모아요	[present, polite]: to aggregate
모양	shape
모으다	to aggregate
모이다	to (be) congregate(d)
모임	gathering
모임을 준비하다	to prepare a gathering
모자	hat
모자라다	to lack
모자를 쓰다	to wear a hat
목	neck
목 마르다	to be thirsty
목걸이	necklace
목도리를 하다	to wear a scarf
목소리	voice
목요일	Thursday
목욕	bath
몰라	[intimate]: I don't know
몸	body
몸무게	body weight
몸이 안 좋다	to not feel well
몸조리	care of health
몸짓	gesture
못생기다	to be ugly
무거워요	it's heavy
무덥다	to be humid/stuffy
무료	free
무릎	knee
무섭다	to be scared
무슨 뜻이에요?	What does (it) mean?
무지개	rainbow
무척	very much
문	door
문법	grammar
문자 메시지를 보내다	to send a text message
문제	problem
문학	literature
묻어요	[present]: to make a stain/to bury
물 마셔야 돼요	I need to drink water
물가	cost of living
물건	stuff/merchandise
물다	to bite
물리다	to be bitten
물어 봐도 돼요?	Can I ask a question?
물어보다	to try asking
물어요	[present]: to ask/to bite
뭐	what
뭐 드릴까요?	What can I get you?
뭐 드실래요?	[honorific]: What would you like to eat?
뭐라고 했어요?	what did (they) say?
뭐라고요?	what did (you) say?
뭔가	something
뭔가 찾았어요?	did you find something?
뭘요	it's nothing (don't mention it)
미국	USA
미끄럽다	to be slippery
미녀	beautiful lady
미래	the future
미술관	art gallery
미용실	beauty salon
미친	crazy
민속촌	Folk village
민지가 춥다고 했어요	Minji said she's cold
믿다	to believe
믿음직스럽다	to be reliable, trustworthy
밀가루	flour
바꾸다	to change
바나나	banana
바다	sea
바닥	floor
바닷가	beach
바람을 쐬다	to get some fresh air
바람이 붑니다	[formal]: wind blows (it's windy)
바로	directly (timing)
바쁘다	to be busy
바지	pants
박물관	museum
박수를 치다	to clap
밖	outside
반갑습니다	to be glad
반값	half price
반드시	surely, certainly
반말	intimate speech style
반바지	shorts
반지	ring
반찬	side dishes
받다	to receive
발	foot
발달하다	to develop
발등	top of the foot
발매기	vending machine
발목	ankle
발바닥	sole
발음	pronunciation
발톱	toenail
발표	presentation
밝다	to be bright
밤	chestnut
밥	cooked rice
밥 먹었냐고요	(I asked) whether you ate
밥 먹으라고 했어요	(someone) told (me) to eat rice
밥 먹을 때 만난 친구예요	This is the friend I met while eating
밥 먹자고 했어요	(someone) told (me) "let's eat food"
밥을 너무 많이 먹어서 배가 아파요	i have a stomachache because I ate too much
방	room
방금	a moment ago
방문하다	to visit
방학 전에 집에 못 가	[intimate]: I cannot go home before the vacation
방학을 잘 보냈어요?	did you have a good vacation? (school)
방해 하지마세요!	don't interrupt me!
방향	direction
배	belly
배	pear
배	ship
배고파요	I'm hungry
배고프니 밥 좀 줘	[intimate]: Give me some rice, because I'm hungry
배구	volleyball
배달	delivery
배드민턴을 치다	to play badminton
배불러요	I'm full
배우	actor
배우는 학생	the student who learns
배우다	to learn
배운 학생	the student who learned
배울 학생	the student who will learn
배터리	battery
백	[sino]: one hundred
백수	a person who is out of work
백화점	department store
버리다	to throw away
버스	bus
번역	translation
번역가가 되다	to become a translator
벌	a pair of (counter)
벌다	To make money
벌레	bug
벌써	Already
벗다	to take off
벚꽃	cherry blossom
베개	pillow
벼락치다	to hit lightning, to cram/study
벽	wall
별	star
별로	not really
별일	anything particular
병	for counting bottles
병원	hospital
보고 싶어요	I want to see you
보고서	report
보내다	to send
보다 더	More than
보라색	[adj]: purple(color)
보십시오	[formal imperative]: to see
보쌈	steamed pork
보여요	it's visible
보이다	to be visible
보자	let's see (plain)
보통	normally
복도	hallway
복잡하다	to be complicated
본인 확인	self-identification
볼거리	things to watch
봄	spring
봉투	envelope
봐라	to see (imperative, plain)
뵈다	[honorific]: to see
부드럽다	to be soft
부르다	to sing a song/to beckon
부모	parents
부모님께 전화하세요	Call (your) parents
부모님께서 저에게 말씀하셨어요	my parents spoke to me
부모님께서는 오늘 오셨다	[plain, honorific]: my parents came today
부모님께서는 책을 읽으신다	[plain, honorific]: my parents read books
부엌	kitchen
부전공이라도 돼	[intimate]: it is okay that it's a minor
부족하다	to be insufficient
부치다	to mail
부탁	request
부터	from (time)
북쪽	north
분	[honorific]: person
분위기가 좋다	to have good ambience
분홍색	[adj]: pink (color)
불고기도 김치도 좋아해요	(I) like both bulgogi and kimchi
불교	Buddhism
불러요	[present polite]: to call/order
불쌍하다	to be pitiful
붙이다	to stick, affix
블라우스	blouse
비	rain
비가 올 것 같은데요	(but) it looks like it's going to rain
비가 와요	it's raining
비누	soap
비밀	secret
비빔밥 먹을래요	I will have Bibimbap.
비빔밥을 먹어야겠다	[plain]: (I think) I should have bibimbap
비슷하다	to be similar
비쌌지만 샀어요	(it) was expensive, but (I) bought.
비열하다	to be mean, nasty
비옷	raincoat
비우다	to empty
비자	visa
비행기	airplane
비행기로 가요?	do you go by airplane?
빌딩	[transliteration]: building
빌려주다	to lend
빌리다	to borrow
빠르다	to be fast
빨간색	[adj]: red (color)
빨래하다	to do laundry
빨리 가요! 늦었는데요	Let's hurry as it's already late
빨리 걸어요	you walk fast
빨리 집에 오라고요	(I said) come back home hurry
빵	bread
빼다	to remove, to take out (cash)
뺏기다	to be deprived of
뻥 치다	to lie
뽀뽀	to kiss
뽑다	to pick
뾰족하다	to be sharp, pointed
사 먹다	to buy and eat
사고	accident
사과	apple
사과가 몇 개 있어요?	How many apples do you have?
사냐?	to live (interrogative, plain)
사람	person
사람마다	every person
사랑한다고 전해 주세요	pass my message that I love
사모님	someone's wife
사무실	office
사세요	buys (polite formal)
사실	fact, truth
사업	business
사용하다	to use (an object)
사우나	sauna
사이	between
사장	CEO
사전	dictionary
사진	photo
사진기	camera
사진을 찍다	to take a photo
사찰	temple
사촌	cousin
사탕	candy
사투리	dialect
사흘	three days
산	mountain
산책	stroll
살기 좋다	to be a good place to live
살다	to live
살살	softly
살아라	to live (imperative, plain)
살이 빠지다	to lose weight
살이 찌다	to gain weight
살자	let's live (plain)
삶다	to boil
삼계탕	chicken soup with ginseng
상관 없어요	doesn't matter
상자	box
상징	symbol
상추	lettuce
새	bird
새	new
새로운	[noun modifying]: brand new
새벽	dawn
새우젓	salted shrimp
색	color
샌들	sandals
샌프란시스코	San Francisco
생각	thought, idea
생각이 안 나요	I don't remember
생기다	to be formed
생년월일	date of birth
생선	fish
생신	[honorific]: birthday
생일	birthday
생활	life (生活）
샤워하다	to shower
서다	to stand
서두르다	to hurry, rush
서른	thirty
서부	West Coast
서비스	service
서재	study room
서점	bookstore
서쪽	west
석굴	stone cave
섞다	to mix, blend
선물	gift
선물을 받았다	[plain]: (I) received a present
선생님	teacher
선생님께 숙제를 내요	[honorific]: (I) submit homework to the teacher
선생님께서는 시를 쓰신다	[plain, honorific]: my teacher writes poetry
선생님을 뵈려고 하는데요	Well, I would like to see the teacher. (Is it possible to see her?)
선수	athlete/player
설렁탕	ox bone soup
설명하다	To explain
섬	island
섭씨	Celsius
성공하다	To succeed
성급하다	to be hasty, rash
성별	gender
성숙하다	to be mature
성적	grade
성함	[honorific]: name
세계일주	world tour (trip around the world)
세수하다	to wash one's face
세우다	to stop, pull over
세탁기	washing machine
세트	a set
셋	[native]: three
셔츠	shirt
소	cow
소개	introduction
소극적이다	to be passive
소금	salt
소리	sound, noise
소매	sleeve
소방서	fire station
소파	sofa
소포	parcel
손	hand
손가락	finger
손님	customer
손목	wrist
손바닥	palm
손을 들다	to raise your hand
손톱	fingernail
쇼핑하다	to shop
수고하다	to put forth effort, take trouble
수다를 떨다	to chatter
수도	capital city
수박	watermelon
수업	class
수업이 재미있었다	[plain]: the class was fun
수영	swimming
수영장	swimming pool
수요일	Wednesday
수저	spoon and chopsticks
수줍다	to be shy
수학	mathematics
숙박	accommodation
숟가락	spoon
술	Alcohol
숫자	number
숯불	charcoal fire
숲	forest
쉬다	to rest
쉬워요, 어려워요?	Is it easy or difficult?
쉬워지다	to become easy
쉰	fifty
쉽다	to be easy
스무 살이에요	I am twenty years old
스물	twenty
스웨터	sweater
스케줄	schedule
스타일	style
스파게티	spaghetti
스포츠	sports
슬리퍼	slipper
슬퍼요	[present]: to be sad
슬프다	to be sad
습관	habit
습하다	to be damp, moist, humid
승무원	flight attendant
승진하다	to be promoted
승차권	ride pass, ticket
시간은 금이다	time is gold
시간을 정하다	to set a time
시간이 있으면 영화를 보고 싶어요	If I have time, I want to watch a movie
시계	clock
시골	countryside
시금치	spinach
시끄러워요	it's loud
시내	downtown
시다	to be sour
시대	period (time)
시원하다	to be cool (feeling)
시월	October
시작하다	To start
시장	market
시청	city hall
시합	game/match
시험	test, exam
시험 때문에 도서관에 가요	(I) go to the library because of a test
시험 전에 물어 보세요	ask before the exam
시험이 쉬운 것 같아요	the test looks easy
시험이 쉬울 것 같아요	the test will look easy
시험이 쉬웠던 것 같아요	the test looked easy
시험이 있으니까 공부하세요	please study, as there'll be an exam
시험이라서 공부를 열심히 해요	As there's an exam, (I) study hard.
식비	food expenses
식사	[honorific]: meal (s)
식사하다	to have a meal
식탁	dining table
신곡	new song
신기하다	to be amazing
신다	to wear (shoes)
신문	newspaper
신발을 신다	to put on shoes
신분증	identification card
신선하다	to be fresh
신용 카드	credit card
신호등	traffic light
실례지만	Excuse me
실례지만 어디세요?	Sorry to bother you, but where are you?
실례하다	to be excused
심심하다	to be bored
심장	heart
십	[sino]: ten
싱겁다	to be bland
싸늘하다	to be chilly, frosty
싸다	to be cheap
싸다	to pack, wrap
싸우다	to fight
쌀	uncooked rice
쌀쌀하다	to be chilly
쓰다	to be bitter
쓰다	to write
쓰레기	garbage, trash
쓰레기통	trash can
쓰세요	please write
씩씩하다	to be brave
씻다	to wash
아까	A little while ago
아내	wife
아니다	not to be
아들	son
아래/밑	bottom
아랫사람	One's junior
아름다운 여자	beautiful girl
아마	probably/maybe
아무거나	anything
아무것도 안 마시고 싶어요	I don't want to drink anything
아무나	anyone
아무도 빵 안 먹고 싶어해요	no one wants to eat bread
아무리 먹어도 배가 고파요	No matter how much I eat, I'm still hungry
아무리 어아도	no matter how
아버지	father
아빠	[informal]: dad
아쉽다	to be sorry
아야지요	expresses obligation
아이	child
아저씨	uncle/mister
아주	very, extremely
아줌마	middle aged woman
아직	still
아직 이해가 안 돼요	i still don't understand
아침	morning
아파요	it hurts
아파트	apartment
아홉	[native]: nine
아흔	ninety
악기	musical instrument
악세사리	accessories
안	inside
안 계신데요	(the person) is not here
안경	glasses
안경을 쓰다	to put on glasses
안내서	guide book, tour brochure
안내하다	to guide
안녕히 가세요	Goodbye (they're leaving)
안다	to hug
안부	regards
안전하다	to be safe
앉다	to sit
않다	to be not; to do not
알겠어요?	do you understand?
알다	to know
알리다	to inform
알림	notice
알아듣다	to understand, recognize
알아보다	to find out/to recognize
앞	front
앞으로	here onwards
애인	lover
야구	baseball
야외	outdoor
야채	vegetables
약	Approximately
약	medicine
약도	rough map
약속	appointment
약속 시간에 늦으면 안 돼요	You should not be late for an appointment
약하다	to be weak
얇은 옷	thin clothes
양력	solar calendar
양말	socks
양복	suit
양파	onion
얘기	Story/Tale
얘기 못해요	I can't say
얘기하자	let's talk
어 본 적이 있다	expresses past experience
어깨	shoulder
어도 되다	It is okay to...
어둡다	to be dark
어디	where
어딘	somewhere
어딘가	Somewhere
어떤 선물을 좋아하세요?	What kinds of presents does he like?
어떻다	to be how
어려우니까 물어보세요	Please ask since it is difficult
어려울 때 친구가 진짜 친구다	a friend in need is a friend indeed
어렵다	to be hard
어른	adult
어리다	to be young (really)
어머	Oh my!
어머니	mother
어서 오세요	Welcome (come one)
어아 가지고	because; by doing
어아 보이다	to appear, look
어아 있다	to be in the state of
어업	fishery
어울리다	to match, suit
어제	yesterday
어치	worth, value
어휘	vocabulary
언니	older sister (from female point of view)
언덕	hill
언어	language
언제	when
언제나	all the time
언젠가	someday
얼굴	face
얼마	how much
얼마나 걸려요?	How long does it take?
얼음이 얼다	to be frozen
엄마	[informal]: mom
없어 보여요	you look poor
없어지다	to disappear
었었 았었 ㅆ었	remote past
엉덩이	butt
에게	to (a person; usually used in writing)
에어컨	air conditioner
엘리베이터	elevator
여권	passport
여기	here
여덟	[native]: eight
여든	eighty
여러분	everyone (大家）
여름	summer
여름방학이기 때문에 한국에 가요	(I) go to Korea because it is summer vacation
여름이 덥지요?	It is hot in summer, isn't it?
여보세요	hello (on the phone)
여섯	[native]: six
여자	female
여자냐고 했어요	(someone) asked if (I'm) a girl
여행사	travel agency
여행하다	to travel
연결하다	to connect, link
연구실	professor's office
연락하다	to contact
연말	end of the year
연세	[honorific]: age
연습하다	to practice
연주	musical performance (usually instrumental)
연필	pencil
연필로 쓰세요	write by pencil
열	[native]: ten
열다	to open
열두 시후에 점심을 먹겠어요	(I)'ll eat lunch after 12 o'clock
열리다	to be open
열쇠	Key
열심히	diligently
열심히 일하고 있어요	I am working hard
열이 나다	to have a fever
영	[sino]: zero
영국	England
영수증	receipt
영어	English
영어 하세요?	Do you speak English?
영어를 배우는데 좀 어려워요	I am learning English, but it is a little hard.
영업시간	business hours
영하	below zero
영화	movie
영화 보는 것을 좋아해요	(I) like watching movies
영화를 본후에 뭘 할까요?	After watching a movie, what shall we do?
옆	side
옆구리	[body party]: side
예능	entertainment
예능인	entertainer
예를 들어	for example
예뻐요	(it's) pretty
예쁜 여자	pretty girl
예순	sixty
예술	art
예약	reservation
예외	exception
예절	manners/etiquette
옛날	the old days
오늘	today
오늘 날씨가 어때요?	How is the weather today?
오늘 뭐 했어요?	what did you do today?
오늘은 공부해야 돼요	I must study today
오늘은 좀 바쁜데요	Sorry, but i'm a little busy today
오늘이라야 해요	It has to be today
오다	to come
오래 걸리다	take a long time
오래된	old
오랜만이에요	Long time no see
오렌지	orange
오른쪽	right
오이	cucumber
오전	a.m.
오후	afternoon
온도	temperature (degrees)
온천	hot spring
올라가다	to go up
올해	this year
옮기다	to move, shift
옷장	closet
옷차림	attire
와요	comes
와이셔츠	dress shirt
완두콩	peas
완성하다	to complete
왕복	round-trip
왜?	why?
외국	foreign country
외국어	foreign language
외로워요	I'm lonely
외모	outward appearance
외우다	to memorize
외투	outerwear
왼쪽	left
요금	fare
요리사	chef
요새	These days
요즘	these days
요즘 어떻게 지내요?	how are you doing these days?
우리	we
우리는 책을 읽는다	[plain]: We read a book
우산	umbrella
우선	first of all
우연히	by chance
우유	milk
우체국	post office
우체부	postman
우체통	postbox
우편	mail
운	luck, fortune
운동장	playground, school field
운동하고 나서 다 같이 밥을 먹으러 갔다	[plain]: After working out, we all went to eat together
운동하다	to exercise
운동하러 체육관에 갈 겁니다	[formal]: I will go to a gym to exercise
운동할 거라고 했어요	(he) said he will exercise
운전하다	to drive
울다	to cry
웃다	to laugh
웃어른	one's elders
원룸	studio apartment
원숭이	monkey
원피스	one-piece dress
원하다	to want (a noun)
월	month
월요일	Monday
웬일	what matter
위	top
위치	location
위하다	To do for the sake of
위험하다	to be dangerous
유난히	particularly
유니폼	uniform
유럽	Europe
유명하다	to be famous
유비무환	prevention is better than cure
유적지	Historic site
유치원	kindergarten
유학을 가다	to study abroad
유행하다	to be in fashion
육	[sino]: six
육개장	spicy beef and leek soup
으니까	expresses reason
으려면	if ... intends to
으로	toward, to
으면 되다	all one needs is
은색	[adj]: silver (color)
은행	bank
음력	lunar calendar
음료수	beverage
음성메시지를 남기다	To leave voice message
음악	music
음악을 들으면 어때요?	How would you like to listen to (some) music?
음악회	music concert (usually classical)
의미	meaning
의사	doctor
의생활	clothing habits
의자	chair
이	Teeth
이 버스는 어디로 갑니까?	[formal]: where does this bus go?
이거 먹어도 됩니까?	[formal]: is it ok to to eat this?
이건	this thing (topic)
이걸	this thing (object)
이게	this thing (subject)
이기다	to win
이다	to be
이따위로	terrible way/manner
이러요	[present]: to be early
이런	Such, like this
이르다	to be early
이를 닦다	to brush one's teeth
이름	name
이모	mother's sister
이미지	image
이민	immigration
이번	this time
이번 주	this week
이번 주말에 영화를 보기로 했다	[plain]: (I) decided to watch a movie this weekend (plain)
이번 주말에 친구와 테니스를 칠 거다	[plain, intimate]: (I) will play tennis with (my) friend this weekend
이사하다	to move (move houses)
이상하다	to be strange
이야기하다	to talk
이용	utilize
이용하다	to use (a service)
이유	reason
이제	from now on
이쪽	this way
이틀	two days
이해하다	to understand
익숙하다	to be familiar
인기가 많다	to be very popular
인기있다	to be popular
인도	sidewalk
인사	greetings
인상적이다	to be impressive
인생은 그런거야	such is life
인터넷	Internet
인터뷰	interview
일	day
일곱	[native]: seven
일기	diary
일기예보	weather forecast
일년 됐어요	It's been 1 year
일본	Japan
일본어	Japanese
일어나다	to get up/stand up/wake up
일요일	Sunday
일을 어떻게 이따위로 한 거야	You messed it up(how on earth did you messed it up)
일찍	early
일하다	to work
일하다가 다쳤어요	(i) hurt (myself) while working
일흔	seventy
읽기도 말하기도 잘해요	(I) am good both at reading and speaking
읽다	to read
읽으세요	please read
읽으십시오	[formal imperative]: to read
읽지 않았습니다	[formal]: (I) did not read
잃어버리다	[informal]: to lose
임신하다	to be pregnant
입	mouth
입구	entrance
입다	to wear (body)
입술	lips
입학하다	to enter school
있을 거예요	will have
잊다	[formal/written]: to forget
잊어버리다	[informal]: to forget
자기 계발	self-improvement
자다	to sleep
자동 발매기	automatic vending machine
자동차	automobile
자동차가 있어요	(i) have a ride
자라다	to grow up
자리	digit
자리	seat
자리를 양보하다	To make room (for someone)
자매	sisters
자세하다	to be detailed
자신 있다	to have confidence
자연	nature
자연스럽다	to be natural
자전거	bicycle
자전거를 타다	to ride a bike
자정	midnight
자주	often
자취하다	to live on one's own
작가	author
작년	[sino]: last year
작지 않았어요	[polite]: it was not small
잔	for counting cups or glasses
잔치	feast, party
잖아요	you know (assuming agreement)
잘 됐네요	It sounds good.
잘 들으세요	please listen carefully
잘 먹겠습니다	I will eat well
잘 모르겠어요	I don't really understand
잘 지내요?	How are you doing?
잘못	wrong
잘못 걸었습니다	dialed the wrong number
잘생기다	to be handsome
잘하다	to do well
잠깐	for a moment
잠깐만 기다리세요	Just a minute, please.
잠실	Jamsil
잠이 들다	to fall asleep
잠이 안와요	can't sleep
잡다	to catch
잡아요	[present]: to catch
잡지	magazine
잡채	japchae
잡히다	to be caught
장갑	gloves
장난이에요	just kidding (it's just a joke)
장마	rainy season
장소	place (location)
장학금	scholarship
재료	ingredient
재미있는 영화를 아세요?	Do you know of any fun movie?
재미있다	to be fun
재미있어요	it is fun
재킷	jacket
저	[formal] I
저건	that thing over there (topic)
저걸	that thing over there (object)
저게	that thing over there (subject)
저기	over there
저기요	Excuse me (to get someone's attention, to call the waiter)
저녁	evening
저는 LA에 있는 여행사에서 표를 사요	I buy the ticket from the travel agency that is in LA
저는 운이 좋아요	i have good luck
저는 이번 주말에 한국어 책을 읽으려고 해요	I intend to read a Korean book this weekend
저는 한국에 가 봤습니다	[formal]: I have been to Korea
저도 집에 가는데 같이 가요	I am also on my way home, so why don't we go together
저쪽	over there, in that direction
저희	[formal]: we/us/our
적그적이다	to be positive
적다	to be small/to be a little
적다	to write down
적어도	at least
적응하다	to adapt
전공	major
전국	The whole country
전데요	it's me
전통	tradition
전통적인 도시다	to be a traditional city
전하다	to tell, convey
전해 드리다	to pass on (for you)
전혀	never
전화를 걸다	to make a call
전화를 끊다	to hang up the phone
전화번호	phone number
전화비	phone bill
전화하다	to phone
절대	absolutely (not)
젊다	to be young
점수	score
점심	lunch
점심 때 친구를 만났어요	I met my friend during lunch time.
점심을 먹으러 왔어요	I came to have lunch
점원	store clerk
점퍼	Jumper
접다	to fold
접속	connection
젓가락	chopsticks
정가	regular price
정강이	shin
정도	approximately
정류장	bus stop
정리하다	to arrange
정말	really
정보	information
정상	summit
정신이 없다	to be really busy (literally 'no life')
정오	noon
정원	garden
정장	formal attire
정직하다	to be honest
정확하다	to be accurate
젖다	to get wet
제	my
제가 돈을 낼게요	[volunteer]: I will pay.
제가 하겠습니다	[formal]: I will do (it).
제가 한 말이 맞아요?	is what i said correct?
제비	swallow
제안하다	to suggest
제일	first, most
조깅하다	to jog
조심하다	to be careful
조용해요	it's quiet
조용히 해주세요	Please be quiet
존대	treatment with respect
존댓말	polite/formal language
존댓말을 써야 합니다	One must use polite expressions
존댓말을 쓰는 것은 어려워요	Use polite expressions is difficult
졸다	to doze off
졸리다	to be sleepy
졸업식	commencement (school)
졸업하다	to graduate
좀 이따 봐요	see you later
좁다	to be narrow
좁아요	it's narrow
종아리	calf
종업원	waiter/waitress; employee
종이	paper
종일	All day, throughout the whole day
좋아지다	To get better
좋은 사람과 결혼하다	to marry a good person
좋은 학교를 아세요?	Do you know of any good school?
좋지도 나쁘지도 않아요	It is neither good nor bad
죄송합니다	I'm sorry
주말	weekend
주말에 뭐 하냐고 했어요	(someone) asked what (I'm) doing during the weekend
주무세요	[formal present]: to sleep
주문하다	to order
주방	Kitchen
주세요	give me
주소	address
주스	juice
주유소	gas station
주인	owner
주인공	protagonist
주차	parking
주차장	parking lot
주황색	[adj]: orange (color)
죽지 마세요	don't die
준비	Preparation
줄이다	to shorten
중간	the middle
중고 가구	used furniture
중고품	used merchandise
중국	China
중국어	Chinese
중심지	center (of)
중요하다	to be important
중학교	middle school
즐겁다	to be playful happy
즐기다	to enjoy
지갑	wallet
지겹다	to be Boring
지구	earth
지금	right now
지금 막 집에 가려고 했어요	(I) was just about to go home
지금 안 오면, 후회할 거예요	if you don't come now, you're will regret it
지나다	to pass by
지난 주	last week
지내다	To pass, spend time
지니다	to keep, carry, have
지다	to lose
지도	map
지루하다	to be boring
지방	region, district
지우개	eraser
지우다	to delete/to erase
지정하다	to appoint
지키다	to guard, protect
지키다	to observe
지하도	the underpass
지하실	basement
지하철	subway
지하철역	subway station
직업	job
직원	Employee
직장인	Office worker
직접	directly (person)
진지	[honorific]: meal (j)
진짜	very
질문 있어요?	do you have a question?
질문하세요	please ask me
짐	luggage, load
집	home
집어넣다	to put something in
집에 가는 길에 친구를 만났다	[plain, intimate]: on the way home, I met my friend
집에 가야겠어요	(I think) I should go home
집에 갈 때 버스를 타요	I take a bus on my way home.
집은 큰데 비쌉니다	[formal]: The house is big, but expensive
집을 떠나 본 사람만이 집의 소중함을 안다	Only those who've been away from home know how precious home is
짓다	to build
짜다	to be salty
짜증나다	to be annoyed
짧다	to be short
쪽	page/direction
쭉	straight
쯤	about, around
찌르다	to pierce
찜질방	korean dry sauna
차	car/tea
차갑다	cold to touch
차다	to kick; to be chilly
차도	road (for cars)
차림표	menu (old)
차이다	To be dumped
차지 마세요	don't kick
착하다	to be nice
참	by the way
참가비	participating fee
참다	to endure
참으세요	control yourself
창가	by the window
창가 자리가 좋겠어요	A window seat would be nice
창문	window
창피하다	to be embarrassed
찾다	to find
책꽂이	bookshelf
책상	desk
책을 보세요	please look at your books
책을 펴세요	please open your books
책이 없는 사람은 누구예요?	who is the person who does not have a book?
책장	Bookshelf, bookcase
처럼	like, as
처음	first time
천장	ceiling
천천히	slowly
첫째 날	first day
청바지	blue jeans
청소기	vacuum cleaner
청소하다	to clean
체감온도	sensory temperature
체신 사업	postal work, postal service
체육관	gym
체험	experience (體驗)
초	second
초대장	invitation
초등학교	elementary school
초록색	[adj]: green (color)
초콜릿	chocolate
촉촉하다	to be moist
추우세요?	Are you cold? (polite formal)
추워요	it's cold
축구	soccer
축제	festival
축축하다	to be damp, clammy, wet
축하하다	to congratulate
출구	exit
출발	departure
출석	attendance
출석을 부르겠어요	I will call roll.
출연하다	to appear
춤추다	to dance
춥다	to be cold
춥지 않아요	[polite]: it is not cold
취미	hobby
취직을 하다	to be hired for a job
치마	skirt
치약	toothpaste
치즈	cheese
친구	friend
친구 만나면 뭐 해요?	What do you do when you meet your friends?
친구 집에 가기 전에 전화를 하겠어요	Before visiting my friend's house, I will call him/her
친구가 놀러 왔어요	My friend came to hang out
친구들	friends
친구하고 갈래요	I will go with my friends.
친구한테 이메일을 써요	(I) write an email to a friend
친절하다	to be kind
친척	Relatives
친하다	to be close (to someone)
칠	[sino]: seven
칠판	blackboard
침대	bed
침실	bedroom
칫솔	toothbrush
카드를 뽑으세요	pick the card
캠핑	camping
커요	[present]: to be big
커지다	To become bigger
커피 사 달라고 했어요	(someone) told (me) to help them buy coffee
커피라고 했어요	(someone) said it is coffee
컴퓨터	computer
컵라면	cup ramen
케이크	cake
켤레	pair (counting marker)
코	nose
코끼리	elephant
코트	coat
콘서트	concert
콩	bean
크다	to be large
크던 옷이 작아졌어요	(the) clothes that used to be large became smaller
크리스는 학교에 간다	[plain]: Chris goes to school
키	key/height
키가 작다	to be short (height)
키가 크다	to be tall
키우다	to raise (a pet)
타고 가다	to go riding
타고 오다	to come riding
탁구	table tennis
태어나다	to be born
택시	taxi
테니스	tennis
토끼	rabbit
토마토	tomato
토요일	Saturday
통역사가 되다	to become an interpretor
통통하다	to be chubby
통화 중입니다	(I) am in the middle of another phone call
트럭으로 왔어요	I came by truck
특별하다	to be special
특히	especially
튼튼하다	to be strong, sturdy
틀다	to turn on, switch on, play (electronics)
틀리다	to be wrong
팁	tip, gratuity
파	scallion
파란색	[adj]: blue (color)
파티	party
팔	[sino]: eight
팔	arm
팔꿈치	elbow
팔다	to sell
팔리다	to be sold
팔짱을 끼다	to cross one's arms
편도	one-way trip
편안하다	to be (safe) comfortable
편의점	convenience store
편지	letter
편지를 받아 봤습니다	[formal]: (I) have the experience of receiving a letter
편찮으시다	[honorific]: to be sick
편하다	to be comfortable, to be convenient
평일	weekday
포도	grape
폭포	waterfall
폴이 읽는 책	the book that paul reads
폴이 읽은 책	the book that paul read
폴이 읽을 책	the book that paul will read
폼생폼사	live cool die cool
표가 비싸지기 시작해요	tickets begin to get expensive
표현	expression
푹	Deeply, well
풀다	to relieve
풍선	balloon
프로그램	program
프린터	printer
피곤해요	I'm exhausted
피다	to bloom
피시방	internet cafe
피아노를 치다	to play the piano
피자	pizza
피자만 먹어요	(I) only eat pizza
피하다	to avoid
하고	and
하나	[native]: one
하나도	not even one
하늘	sky
하늘색	sky blue
하루 종일	all day
하숙방	a room in a boardinghouse
하얀색	[adj]: white (color)
하지 마라	don't do (plain)
하지만	[3]: but, however
하지만, 웃는 학생은 많아요	However, there are lots of students who laugh
학교 가는 길에 커피를 산다	[plain]: on the way to school, I buy a coffee
학교가 큰 것 같아요	[polite]: It seems that the school is big
학교에 갔지요?	You went to school, didn't you?
학교에 안 가도 돼요?	Is it ok if I do not go to school?
학교에 언제 가냐고 했어요	(someone) asked when (I'm) going to school
학교에도 체육관에도 가요	I go to (both) school and the gym
학기	semester
학비	tuition
학생이었지만 돈이 많았어요	(I) was a student, but had lots of money
한국	Korea
한국 문화에 관심이 있다	to be interested in korean culture
한국 사람이냐고 했어요	(someone) asked if (I'm) korean
한국 친구를 사귀다	to network with korean friends
한국과 무역을 하다	to do business in korea
한국어	Korean
한국어 배우는 것이 재미있어요	Learning Korean is fun
한국어 수업 시간에 영어를 하면 안 돼요	You must not speak English in Korean class
한국어 수업에서 자는 학생들은 없어요	there are no students who sleep in Korean class
한국어 수업을 듣고 나서 한국에 대해 배웠다	[plain]: After taking a Korean class, I learned about Korea
한복	traditional Korean dress
한심하다	Be pathetic, pitiful
한참 걸리다	take a while
한테	to (a person or an animal; colloquial form)
한테서	from (a person or an animal; colloquial form)
할머니께서는 한국에 계세요	my grandmother is in Korea
할수 없어요	you can't do it
할수 없지	can't do (anything about it)
할수 있어요	you can do it
할아버지	grandfather
함께	[honorific]: together
항상	always
해	sun
해소하다	to resolve, settle matters (to relieve)
해외	overseas
핸드폰	cellular phone
햄버거	hamburger
행복해요	I am happy
향기	fragrance
허락하다	to allow, consent
허리	waist
허벅지	thigh
헤어지다	to break up
현금	cash
현대적인 도시다	to be a modern city
현재	currently
형	older brother (from male point of view)
형제	brothers
호박	pumpkin, squash
호선	subway line
호수	lake
호주	Australia
호텔	hotel
혹시	by any chance
혼자	alone
혼자서	alone
홍수	flood (noun)
화가 나다	To be angry
화가 풀리다	for anger to dissipate
화랑	gallery
화려하다	to be fancy
화법	speech style
화요일	Tuesday
화장	makeup
화장실	bathroom
화장품	cosmetics
확실해?	Are you sure?
확인	check; confirmation
환승하다	to Transfer
활동	activity
회비를 모으다	to collect dues
회사	company
회사원	office worker
회색	[adj]: grey color
회의	meeting
횡단보도	crosswalk
휴가 때 뭐 했어요?	what did you do during your vacation?
휴게실	lounge, common room
휴대 전화	cell phone
휴식	break
휴일	holiday
휴지	toilet paper
흐리다	to be cloudy
흑기사	dark knight
희망	hope
흰색	white
힌트	hint
힘내다	To cheer up
힘들어요	I'm tired
힘이 세다	for strength to be strong
